,gene,ranking_KNN,ranking_XGB,sum_ranks,ranking_CAI_he,ranking_CAI_all,ranking_tAI,description
0,YER043C,9,9,18,159,120,179,
1,YDL061C,15,5,20,126,2472,262,
2,YOR332W,5,22,27,915,5012,373,
3,YJR047C,12,20,32,120,219,163,
4,YLR043C,17,17,34,252,31,229,
5,YGR192C,23,13,36,2,325,9,
6,YBR025C,31,8,39,193,40,208,
7,YJR139C,36,4,40,262,67,272,
8,YLR388W,3,37,40,197,1504,288,
9,YLR150W,40,1,41,132,620,25,
10,YLR262C-A,37,7,44,401,335,394,
11,YDR050C,26,19,45,24,117,76,
12,YPL106C,33,14,47,244,180,175,
13,YOR133W,27,24,51,44,134,83,
14,YER165W,53,11,64,259,119,218,
15,YLR264W,19,46,65,282,4008,120,
16,YDR385W,32,35,67,47,130,85,
17,YER177W,35,33,68,617,3366,354,
18,YDR099W,13,57,70,360,354,314,
19,YHR064C,29,41,70,280,210,251,
20,YOL086C,10,63,73,72,277,132,
21,YDL085C-A,63,10,73,543,466,298,
22,YJL052W,56,32,88,17,191,54,
23,YBR196C,71,18,89,140,195,144,
24,YLR134W,55,34,89,57,16,143,
25,YLR249W,60,36,96,41,32,79,
26,YDL022W,39,58,97,298,424,292,
27,YJR009C,47,53,100,8,358,21,
28,YER091C,42,67,109,147,70,123,
29,YLR044C,11,105,116,1,137,31,
30,YOR198C,24,93,117,353,742,226,
31,YBR249C,7,111,118,234,168,260,
32,YGR144W,22,98,120,305,412,362,
33,YLR354C,69,60,129,218,252,145,
34,YOL109W,72,74,146,231,294,43,
35,YGR254W,116,31,147,7,116,15,
36,YGR027C,141,15,156,123,183,67,
37,YEL017C-A,81,84,165,223,33,343,
38,YHR174W,162,3,165,9,228,10,
39,YBR011C,123,44,167,171,255,159,
40,YMR116C,149,23,172,49,125,105,
41,YPR102C,85,92,177,54,154,68,
42,YKR059W,174,6,180,65,75,98,
43,YJL026W,166,16,182,276,753,231,
44,YOR167C,50,132,182,299,3856,149,
45,YEL034W,21,164,185,21,126,93,
46,YER036C,130,59,189,369,404,377,
47,YMR260C,65,125,190,281,41,381,
48,YLR109W,68,123,191,221,486,249,
49,YDL100C,51,141,192,429,530,453,
50,YGL135W,143,50,193,18,275,32,
51,YPL220W,94,101,195,20,237,35,
52,YHR039C-A,73,122,195,403,537,210,
53,YAL012W,104,97,201,382,3381,374,
54,YCL018W,2,200,202,304,246,355,
55,YJL138C,176,27,203,66,76,99,
56,YLR192C,25,181,206,533,462,346,
57,YCR012W,135,78,213,48,301,14,
58,YLR340W,70,145,215,50,65,23,
59,YGR285C,111,104,215,275,536,197,
60,YHR193C,96,121,217,235,570,133,
61,YOR375C,46,172,218,207,371,238,
62,YDL192W,219,2,221,217,68,315,
63,YLR301W,118,109,227,438,327,454,
64,YJL190C,79,154,233,23,78,80,
65,YBR127C,187,48,235,347,439,360,
66,YLL045C,150,89,239,14,127,2,
67,YPR052C,158,81,239,472,2119,234,
68,YML028W,205,39,244,137,528,119,
69,YGL147C,105,139,244,78,681,72,
70,YFL045C,75,170,245,210,95,200,
71,YPL037C,228,21,249,182,390,116,
72,YKR057W,120,129,249,211,494,205,
73,YDR002W,28,222,250,254,144,224,
74,YGL105W,189,65,254,341,478,295,
75,YML024W,109,148,257,39,151,40,
76,YOL039W,233,29,262,42,19,0,
77,YLR367W,4,259,263,250,305,206,
78,YNL208W,220,45,265,1545,4233,888,
79,YIR035C,171,95,266,1400,4861,710,
80,YOL139C,48,220,268,318,182,401,
81,YEL054C,18,252,270,188,139,160,
82,YDR502C,44,226,270,219,99,277,
83,YHR010W,90,180,270,109,318,89,
84,YNL178W,16,255,271,37,26,45,
85,YHR019C,231,43,274,359,1000,307,
86,YHR068W,113,162,275,297,164,384,
87,YBR089C-A,119,157,276,640,1271,278,
88,YLR441C,226,54,280,113,97,71,
89,YHR049W,14,268,282,327,607,312,
90,YML063W,244,47,291,45,47,48,
91,YBL099W,155,136,291,295,141,287,
92,YML058W-A,203,90,293,485,6225,482,
93,YDR037W,208,86,294,303,256,320,
94,YGR085C,201,96,297,115,267,110,
95,YJL136C,218,82,300,151,332,121,
96,YDR226W,103,198,301,237,156,185,
97,YFL014W,243,62,305,179,531,65,
98,YLR293C,112,193,305,164,91,221,
99,YDR447C,100,206,306,81,96,77,
100,YPR074C,125,182,307,269,212,276,
101,YNL055C,84,224,308,420,1070,359,
102,YGL253W,52,256,308,156,53,158,
103,YLR448W,101,210,311,202,562,73,
104,YHR179W,66,247,313,313,419,332,
105,YDL081C,161,153,314,106,25,49,
106,YER074W,78,239,317,53,491,5,
107,YOR184W,140,179,319,673,779,610,
108,YPR035W,195,124,319,236,322,261,
109,YLL050C,157,169,326,203,48,223,
110,YLR303W,34,293,327,258,86,293,
111,YDR023W,82,249,331,320,203,334,
112,YPL131W,151,184,335,28,104,52,
113,YMR318C,194,146,340,520,702,585,
114,YBR079C,6,336,342,407,521,300,
115,YDR233C,215,128,343,319,269,352,
116,YDL185W,30,314,344,477,411,491,
117,YMR186W,102,242,344,199,59,103,
118,YMR217W,278,69,347,283,245,302,
119,YHR183W,80,269,349,169,207,196,
120,YBR031W,177,173,350,82,313,62,
121,YDR450W,64,287,351,59,293,114,
122,YDR158W,293,61,354,316,321,309,
123,YLR355C,127,228,355,60,346,108,
124,YGL030W,245,112,357,11,90,22,
125,YLR432W,297,64,361,271,93,306,
126,YDL084W,296,68,364,355,240,349,
127,YBR072W,264,108,372,460,953,344,
128,YDR174W,316,56,372,565,2061,366,
129,YHR072W-A,98,275,373,323,297,257,
130,YML026C,122,253,375,84,369,135,
131,YNL209W,351,25,376,74,74,38,
132,YIL053W,163,213,376,133,268,151,
133,YKL156W,238,140,378,391,216,378,
134,YNL015W,258,120,378,345,1963,263,
135,YGR155W,62,318,380,423,600,391,
136,YBL072C,45,339,384,102,113,118,
137,YCR028C-A,148,246,394,419,495,321,
138,YHL033C,227,171,398,25,136,13,
139,YAL003W,212,188,400,71,112,39,
140,YPR080W,310,91,401,6,60,37,
141,YBR118W,309,94,403,4,69,36,
142,YGL256W,132,272,404,189,55,230,
143,YHR128W,175,229,404,436,988,431,
144,YJR070C,274,135,409,372,822,340,
145,YOR276W,409,0,409,356,263,446,
146,YDR353W,237,175,412,572,1042,368,
147,YLL024C,253,160,413,36,71,33,
148,YMR242C,223,191,414,100,338,81,
149,YIR037W,375,42,417,1286,2990,631,
150,YPL231W,319,99,418,321,234,296,
151,YPL048W,262,156,418,374,1955,290,
152,YGL009C,121,300,421,380,175,447,
153,YGR159C,91,335,426,285,299,198,
154,YBR143C,74,353,427,378,152,437,
155,YNL096C,260,167,427,205,284,155,
156,YDR032C,277,151,428,365,337,350,
157,YAL005C,165,264,429,118,155,87,
158,YOR210W,8,421,429,293,39,413,
159,YDR368W,284,147,431,661,505,502,
160,YDL229W,329,103,432,32,45,20,
161,YER030W,255,183,438,630,509,326,
162,YNL079C,411,30,441,784,4695,214,
163,YOR063W,95,349,444,19,148,78,
164,YMR099C,335,116,451,418,184,586,
165,YCR053W,307,144,451,324,474,324,
166,YDR012W,214,238,452,73,287,64,
167,YIL069C,252,203,455,90,324,27,
168,YJL121C,340,117,457,604,2319,488,
169,YEL026W,93,364,457,155,34,180,
170,YDR064W,58,402,460,61,89,69,
171,YOR096W,250,211,461,63,17,34,
172,YCR004C,398,72,470,1292,1403,1012,
173,YHR021C,225,245,470,143,4,201,
174,YGR037C,430,40,470,439,1629,325,
175,YLR333C,146,330,476,196,220,170,
176,YHR020W,342,137,479,444,739,358,
177,YLL018C,453,28,481,482,1873,361,
178,YHR025W,270,212,482,878,4186,680,
179,YDR025W,206,276,482,148,956,128,
180,YDR454C,432,52,484,478,520,419,
181,YPL249C-A,325,161,486,104,637,46,
182,YBR121C,305,185,490,301,72,280,
183,YGL157W,276,215,491,1143,989,864,
184,YOR312C,126,366,492,95,229,115,
185,YGR008C,114,379,493,404,680,333,
186,YNL016W,381,114,495,452,498,487,
187,YCL026C-B,336,165,501,624,2593,494,
188,YDL137W,476,26,502,348,809,365,
189,YMR303C,0,511,511,286,768,240,
190,YLR364W,465,49,514,1181,926,1285,
191,YGR180C,239,284,523,256,613,250,
192,YLR075W,291,233,524,27,174,100,
193,YBR106W,167,361,528,245,695,235,
194,YER110C,444,87,531,421,315,399,
195,YJR123W,234,303,537,22,87,12,
196,YDR155C,38,500,538,204,836,131,
197,YDR461W,469,71,540,206,384,285,
198,YAL038W,337,205,542,10,398,41,
199,YAR075W,188,354,542,434,436,483,
200,YLR179C,436,107,543,2401,5822,1093,
201,YPR028W,257,291,548,409,226,561,
202,YER081W,449,100,549,402,218,481,
203,YKR097W,61,489,550,433,400,549,
204,YLR048W,217,334,551,83,9,96,
205,YDR071C,486,66,552,715,1353,786,
206,YJR094W-A,137,417,554,183,12,305,
207,YGL123W,172,382,554,58,88,56,
208,YLR061W,242,313,555,16,490,7,
209,YML008C,408,150,558,450,342,510,
210,YOR020C,357,207,564,497,1035,329,
211,YHR087W,197,368,565,718,2731,461,
212,YLR175W,349,217,566,361,328,339,
213,YNL255C,491,75,566,317,410,1033,
214,YOL143C,315,251,566,896,1514,793,
215,YOR369C,377,195,572,15,11,4,
216,YDR453C,142,436,578,546,669,490,
217,YOR310C,303,279,582,334,145,270,
218,YNL135C,20,562,582,272,582,189,
219,YOL058W,229,356,585,343,618,316,
220,YLR377C,356,231,587,1822,4634,1266,
221,YNL239W,431,158,589,676,2140,580,
222,YBR149W,424,166,590,1178,2169,804,
223,YJL189W,287,305,592,0,190,26,
224,YEL047C,344,248,592,769,2099,493,
225,YFR047C,507,88,595,1633,3950,1587,
226,YNL131W,168,431,599,443,169,539,
227,YOL151W,345,258,603,786,2473,647,
228,YPR165W,551,55,606,615,603,772,
229,YKL081W,136,471,607,200,138,199,
230,YLR180W,115,493,608,296,1299,269,
231,YHL034C,423,186,609,415,635,244,
232,YGL026C,339,271,610,468,482,514,
233,YGL076C,282,328,610,88,244,58,
234,YJR105W,327,285,612,431,1765,357,
235,YGR185C,376,236,612,529,599,489,
236,YML073C,160,456,616,141,359,57,
237,YKL060C,279,338,617,5,232,63,
238,YOR224C,415,202,617,755,2576,843,
239,YCR024C-A,204,413,617,94,1,182,
240,YER009W,199,419,618,432,744,509,
241,YPR043W,99,523,622,13,57,183,
242,YDL075W,134,490,624,122,309,53,
243,YGR086C,555,73,628,437,712,317,
244,YER057C,618,12,630,549,724,392,
245,YDR500C,169,468,637,124,230,294,
246,YMR143W,164,474,638,127,13,147,
247,YNL274C,301,341,642,2290,3424,1565,
248,YDR210W,379,263,642,480,159,2289,
249,YDL244W,230,414,644,255,545,259,
250,YJR145C,251,395,646,139,551,126,
251,YOR182C,196,451,647,92,21,61,
252,YOL055C,442,209,651,585,421,863,
253,YPL225W,371,282,653,588,225,424,
254,YNL332W,145,509,654,248,556,266,
255,YBL027W,89,568,657,134,393,59,
256,YBR084C-A,152,506,658,135,311,109,
257,YNL302C,144,519,663,80,49,95,
258,YLR058C,1,663,664,187,173,213,
259,YGR201C,533,133,666,4662,5567,2886,
260,YBR154C,304,362,666,481,208,570,
261,YPR183W,400,267,667,2197,6240,1055,
262,YBL030C,129,542,671,229,79,275,
263,YJR156C,222,450,672,253,518,253,
264,YFL039C,520,152,672,128,149,194,
265,YLR372W,380,292,672,331,278,383,
266,YLR438W,365,309,674,921,5899,695,
267,YGR019W,350,326,676,559,622,568,
268,YJR096W,353,323,676,1006,1774,980,
269,YFR032C-A,156,530,686,142,450,152,
270,YKL080W,610,79,689,733,976,612,
271,YPL226W,289,404,693,483,375,574,
272,YKL181W,399,295,694,720,1152,538,
273,YNL112W,154,541,695,312,276,335,
274,YDR487C,346,359,705,1134,2159,970,
275,YEL009C,273,433,706,912,986,740,
276,YBR164C,468,243,711,1190,593,1507,
277,YJL153C,548,163,711,2460,4730,1128,
278,YFR031C-A,131,581,712,96,370,134,
279,YDL184C,489,227,716,370,3368,313,
280,YOR051C,343,378,721,1030,1384,1017,
281,YER025W,275,446,721,446,406,486,
282,YJR007W,182,540,722,366,224,363,
283,YGL202W,649,77,726,653,766,898,
284,YKR014C,299,430,729,934,515,978,
285,YNL220W,467,262,729,388,179,427,
286,YIL018W,107,624,731,97,285,140,
287,YER102W,106,626,732,121,61,150,
288,YIL041W,521,216,737,1362,4319,556,
289,YML124C,440,299,739,903,2193,787,
290,YMR120C,410,331,741,441,339,466,
291,YDL083C,184,558,742,91,295,92,
292,YBR111C,392,351,743,714,1464,664,
293,YGL062W,361,384,745,699,890,602,
294,YLR027C,524,221,745,1112,3921,1151,
295,YLR363W-A,374,373,747,704,506,496,
296,YDL004W,367,381,748,992,380,765,
297,YDL136W,236,515,751,117,227,19,
298,YFR053C,317,435,752,294,262,264,
299,YDR510W,577,176,753,602,1996,347,
300,YOL127W,181,577,758,62,56,18,
301,YNL010W,292,466,758,358,261,532,
302,YPL218W,451,310,761,337,94,475,
303,YJL167W,572,190,762,394,1050,303,
304,YPL004C,569,201,770,742,825,599,
305,YFL058W,190,582,772,241,565,241,
306,YLR197W,619,155,774,336,107,337,
307,YMR175W,59,720,779,489,641,330,
308,YJR010W,493,289,782,499,522,507,
309,YIL062C,545,241,786,4482,4567,4787,
310,YLR167W,159,628,787,33,401,102,
311,YDL191W,246,548,794,77,142,17,
312,YDR035W,691,106,797,632,938,588,
313,YPL276W,685,118,803,1402,4153,768,
314,YBR082C,587,218,805,442,967,693,
315,YNL248C,324,483,807,922,1360,755,
316,YCL035C,725,83,808,2015,3795,644,
317,YFR044C,412,400,812,527,705,545,
318,YKL152C,207,609,816,29,63,28,
319,YMR235C,487,333,820,986,1063,983,
320,YDR432W,483,340,823,396,378,395,
321,YLR244C,528,296,824,459,303,916,
322,YML106W,547,277,824,728,1718,683,
323,YOR388C,713,113,826,1651,3122,861,
324,YIL052C,341,488,829,87,280,112,
325,YKL035W,416,415,831,457,1102,438,
326,YJR045C,609,225,834,263,403,173,
327,YBL092W,393,441,834,35,612,47,
328,YPL061W,179,657,836,243,394,233,
329,YDR418W,88,750,838,68,28,82,
330,YOL040C,192,648,840,75,100,91,
331,YGL245W,632,208,840,267,282,248,
332,YGL039W,419,422,841,1151,1679,1094,
333,YLR060W,473,370,843,474,1239,443,
334,YJR025C,604,240,844,1626,2288,1674,
335,YHL015W,333,512,845,38,291,30,
336,YIL116W,372,473,845,927,1186,942,
337,YIL002W-A,647,199,846,2572,2871,947,
338,YIR038C,766,80,846,817,1416,849,
339,YPR132W,261,585,846,51,165,84,
340,YPL154C,286,567,853,425,452,372,
341,YPL237W,659,197,856,551,579,559,
342,YNL162W,138,719,857,79,292,165,
343,YER056C-A,295,564,859,101,200,127,
344,YBL024W,370,492,862,525,307,643,
345,YMR079W,506,358,864,466,248,504,
346,YML022W,455,411,866,829,1254,581,
347,YDR044W,313,560,873,292,448,386,
348,YHR005C-A,642,232,874,736,373,866,
349,YBR109C,827,51,878,887,759,1141,
350,YER062C,285,600,885,592,1518,380,
351,YNL044W,288,597,885,918,2021,1091,
352,YML074C,816,70,886,390,785,232,
353,YDR321W,621,266,887,972,1269,998,
354,YNL067W,180,710,890,56,584,66,
355,YBR035C,590,301,891,966,2480,762,
356,YER019C-A,571,321,892,1661,4352,924,
357,YOL121C,193,704,897,52,20,75,
358,YLR270W,519,383,902,621,1081,630,
359,YJL080C,503,405,908,451,476,398,
360,YGR214W,224,687,911,149,105,161,
361,YOR294W,348,570,918,1010,940,595,
362,YNL064C,320,598,918,351,157,421,
363,YER126C,611,308,919,495,426,376,
364,YOR253W,663,260,923,1306,756,1197,
365,YDR063W,791,134,925,2669,2205,971,
366,YKL104C,406,522,928,606,442,707,
367,YML126C,494,442,936,315,288,385,
368,YER049W,474,462,936,642,985,729,
369,YMR131C,574,363,937,877,619,885,
370,YOR185C,794,143,937,654,548,699,
371,YEL021W,543,396,939,1892,1635,744,
372,YAR015W,575,365,940,1155,3426,658,
373,YBR244W,622,320,942,1164,1352,663,
374,YAL049C,488,455,943,2116,3106,1241,
375,YAL035W,594,350,944,428,423,322,
376,YLR050C,332,612,944,2028,5143,2701,
377,YML056C,397,551,948,257,124,291,
378,YHR208W,576,372,948,398,402,435,
379,YMR169C,687,261,948,1570,2123,1219,
380,YDL133C-A,505,444,949,332,2069,299,
381,YJL068C,562,388,950,1460,4506,1308,
382,YMR183C,583,369,952,812,2338,500,
383,YKL056C,620,332,952,99,356,88,
384,YGR209C,290,664,954,310,260,254,
385,YOR045W,198,758,956,576,365,389,
386,YMR027W,630,327,957,1309,1956,1160,
387,YDR298C,682,280,962,959,871,674,
388,YMR174C,777,187,964,3560,5480,1185,
389,YFR009W,542,424,966,558,456,572,
390,YLR185W,281,686,967,138,233,274,
391,YOL120C,334,634,968,30,38,55,
392,YOR095C,669,304,973,671,271,655,
393,YGR061C,629,348,977,513,323,667,
394,YOR323C,840,138,978,836,814,516,
395,YGR124W,500,480,980,494,1116,480,
396,YML085C,497,484,981,627,594,691,
397,YCR031C,355,627,982,40,10,74,
398,YPR103W,481,502,983,985,919,1165,
399,YMR170C,774,219,993,2188,2639,1540,
400,YGL031C,183,824,1007,85,108,16,
401,YOR230W,894,115,1009,591,1370,682,
402,YBR162W-A,592,420,1012,2372,3526,2439,
403,YFR033C,602,418,1020,2482,4626,596,
404,YLR076C,446,576,1022,473,4528,1962,
405,YLR216C,721,306,1027,648,583,628,
406,YGR240C,921,110,1031,273,172,286,
407,YHR141C,221,812,1033,55,249,168,
408,YKL142W,845,189,1034,1588,2398,948,
409,YOR215C,675,360,1035,881,1684,590,
410,YOR335C,516,526,1042,339,266,356,
411,YGR087C,443,605,1048,3116,4457,1506,
412,YBR137W,707,344,1051,2250,2438,2770,
413,YEL020W-A,767,294,1061,1014,4615,1067,
414,YGR043C,870,192,1062,2328,1677,1132,
415,YBR006W,366,698,1064,1296,708,1101,
416,YLR359W,499,566,1065,447,213,473,
417,YJR074W,982,85,1067,4814,6059,1423,
418,YDL066W,323,746,1069,511,1795,440,
419,YKL117W,943,126,1069,458,129,441,
420,YGL055W,97,975,1072,192,196,256,
421,YDL067C,386,688,1074,1068,5989,393,
422,YDR471W,110,966,1076,261,507,190,
423,YGL206C,312,764,1076,566,438,553,
424,YGL221C,754,322,1076,1523,4902,1229,
425,YGR118W,308,769,1077,119,162,136,
426,YKL009W,247,832,1079,574,563,455,
427,YLR449W,789,290,1079,768,1798,506,
428,YER131W,173,908,1081,146,85,142,
429,YML001W,586,496,1082,1422,819,1899,
430,YKR043C,605,479,1084,2762,5550,1309,
431,YIL078W,811,274,1085,309,192,311,
432,YIL094C,715,371,1086,496,493,422,
433,YMR090W,839,250,1089,1479,1533,1054,
434,YDL171C,701,389,1090,510,467,624,
435,YOR007C,913,178,1091,1157,405,743,
436,YDR148C,613,478,1091,943,1095,505,
437,YHR163W,819,273,1092,2598,3450,2133,
438,YGR282C,462,630,1092,260,206,336,
439,YGR034W,328,766,1094,89,251,29,
440,YLR287C-A,268,835,1103,163,81,164,
441,YGL189C,241,864,1105,76,185,141,
442,YAL060W,331,777,1108,1107,3278,1030,
443,YBR048W,318,792,1110,103,748,148,
444,YKL150W,662,453,1115,626,1313,746,
445,YLR028C,678,437,1115,2850,3465,1436,
446,YBR234C,939,177,1116,1188,1831,1522,
447,YKL180W,369,752,1121,46,18,60,
448,YGR284C,556,565,1121,695,557,802,
449,YPR016C,450,671,1121,528,573,803,
450,YAL044C,957,168,1125,4550,5664,1147,
451,YNL141W,640,485,1125,757,781,872,
452,YNR046W,394,735,1129,3200,6257,1917,
453,YJL122W,385,749,1134,1203,2983,650,
454,YLR153C,401,737,1138,342,222,439,
455,YDL168W,639,507,1146,804,555,769,
456,YMR309C,360,786,1146,412,243,471,
457,YJL097W,728,423,1151,1267,2280,1766,
458,YMR243C,454,699,1153,844,709,1342,
459,YER136W,603,550,1153,701,580,703,
460,YJR069C,750,408,1158,1405,2910,850,
461,YNL002C,527,633,1160,772,542,541,
462,YML131W,585,579,1164,982,601,1542,
463,YKL113C,373,794,1167,2726,1617,1360,
464,YCL043C,862,307,1169,405,3468,328,
465,YKR046C,624,546,1170,2611,5785,721,
466,YMR250W,300,870,1170,2026,2686,1825,
467,YMR230W,322,850,1172,12,6,107,
468,YNL244C,923,257,1180,898,1897,606,
469,YDR129C,1037,149,1186,860,675,702,
470,YDL041W,266,924,1190,3886,5053,3149,
471,YGR232W,856,337,1193,1372,604,1842,
472,YDL029W,464,729,1193,1047,802,1102,
473,YCR020C,597,602,1199,876,920,1313,
474,YOR027W,579,620,1199,766,821,594,
475,YDL208W,363,837,1200,308,553,255,
476,YMR072W,903,298,1201,641,1208,756,
477,YPL079W,49,1156,1205,110,363,130,
478,YBR018C,403,802,1205,799,427,1662,
479,YPL262W,1106,102,1208,811,1742,782,
480,YGR020C,396,813,1209,503,1709,464,
481,YHR143W-A,988,223,1211,540,308,526,
482,YPR129W,822,391,1213,1136,2101,984,
483,YCL026C-A,254,962,1216,593,929,584,
484,YOR298C-A,536,682,1218,816,1852,318,
485,YIL033C,645,574,1219,3004,5746,1549,
486,YDR101C,477,742,1219,706,429,826,
487,YGR287C,694,527,1221,748,1946,797,
488,YBR230C,753,469,1222,2217,5323,2320,
489,YGL037C,706,516,1222,492,1793,550,
490,YNL111C,185,1041,1226,352,205,485,
491,YDL082W,259,971,1230,150,42,94,
492,YOR164C,607,625,1232,1004,636,1226,
493,YBL039C,708,528,1236,462,434,548,
494,YKR094C,265,972,1237,93,197,162,
495,YCL037C,496,744,1240,618,1879,529,
496,YJR104C,422,819,1241,413,2952,405,
497,YOR280C,813,428,1241,1996,1739,2476,
498,YHR065C,378,865,1243,1220,710,1083,
499,YJR016C,723,521,1244,389,561,418,
500,YPR163C,928,316,1244,392,133,319,
501,YPR113W,445,800,1245,2041,3791,2683,
502,YOR270C,248,1000,1248,426,290,593,
503,YBR218C,480,768,1248,524,696,484,
504,YLR378C,686,563,1249,1210,4944,784,
505,YMR205C,964,288,1252,246,118,252,
506,YHR089C,1039,214,1253,1115,3702,677,
507,YOR303W,532,724,1256,888,1274,1002,
508,YNL037C,809,449,1258,675,1948,525,
509,YJR005C-A,710,549,1259,3052,2135,420,
510,YCR102C,534,730,1264,1753,3636,827,
511,YBL036C,922,342,1264,737,357,544,
512,YLR327C,599,668,1267,1046,5130,367,
513,YBR169C,729,538,1267,1699,1917,808,
514,YIL066C,447,822,1269,557,649,670,
515,YPL240C,240,1032,1272,251,160,139,
516,YNL301C,108,1166,1274,158,201,146,
517,YPL198W,209,1068,1277,129,147,90,
518,YMR173W,1240,38,1278,329,1380,460,
519,YDL051W,670,608,1278,998,2373,495,
520,YIL136W,470,811,1281,4922,5877,846,
521,YDR225W,272,1013,1285,144,3,167,
522,YBR189W,283,1006,1289,34,35,3,
523,YHR203C,280,1012,1292,130,525,117,
524,YEL071W,779,514,1293,929,1277,993,
525,YDL124W,952,343,1295,1592,2701,972,
526,YDR086C,699,596,1295,311,239,279,
527,YMR226C,740,561,1301,1909,3941,770,
528,YBR181C,54,1253,1307,31,128,6,
529,YBR191W,83,1228,1311,131,273,166,
530,YJL166W,186,1125,1311,532,132,1784,
531,YGR001C,448,867,1315,623,571,1173,
532,YFL022C,1051,265,1316,562,3438,534,
533,YNL147W,665,656,1321,1037,487,1095,
534,YCR105W,627,696,1323,1508,3643,1463,
535,YLL008W,564,761,1325,1020,2065,615,
536,YDR172W,306,1022,1328,455,430,444,
537,YDR214W,850,481,1331,3349,5444,1257,
538,YER103W,838,494,1332,2232,1369,876,
539,YFL037W,746,592,1338,664,1636,727,
540,YCL040W,785,554,1339,5138,6301,1515,
541,YGR256W,1072,270,1342,1256,1806,900,
542,YGL225W,804,539,1343,448,621,577,
543,YPL160W,553,791,1344,484,333,458,
544,YMR315W,404,945,1349,730,933,573,
545,YDR391C,677,675,1352,2042,3110,1454,
546,YNL207W,459,894,1353,1221,2326,1970,
547,YJL191W,235,1120,1355,208,355,191,
548,YPL223C,582,773,1355,1582,5614,518,
549,YLR209C,742,616,1358,3118,2535,2847,
550,YDL014W,593,767,1360,289,310,225,
551,YKL212W,695,666,1361,1064,2199,1214,
552,YDL160C,1107,254,1361,948,784,1111,
553,YDR354C-A,755,606,1361,2586,883,1051,
554,YDR047W,828,534,1362,3022,4672,1237,
555,YLR460C,778,589,1367,1716,2434,1009,
556,YML086C,857,513,1370,805,820,1014,
557,YBR221C,834,537,1371,445,366,396,
558,YNR053C,498,874,1372,1058,1892,854,
559,YKL172W,646,726,1372,662,646,379,
560,YDL232W,945,427,1372,306,1234,327,
561,YBL045C,875,497,1372,541,994,459,
562,YDL135C,761,611,1372,1321,1100,1409,
563,YGR138C,600,774,1374,467,451,712,
564,YGL097W,510,869,1379,1237,2166,1047,
565,YMR202W,631,748,1379,505,1819,598,
566,YCR051W,1027,357,1384,6050,6441,1000,
567,YHR044C,1062,324,1386,3067,1544,1929,
568,YJL130C,676,711,1387,518,392,562,
569,YIL074C,929,461,1390,683,497,825,
570,YCR075W-A,1097,297,1394,3670,4716,1711,
571,YDR098C,866,533,1399,1607,2508,1088,
572,YLR009W,861,543,1404,373,304,273,
573,YNR016C,859,552,1411,435,417,426,
574,YBR053C,658,754,1412,1668,1943,2940,
575,YPR069C,944,470,1414,354,257,351,
576,YNR057C,844,575,1419,5936,5483,3321,
577,YIR012W,703,717,1420,3063,3053,1706,
578,YDL228C,526,895,1421,538,4843,3805,
579,YER065C,563,862,1425,777,1287,578,
580,YDR070C,1052,374,1426,679,1453,390,
581,YJL177W,117,1312,1429,154,51,111,
582,YBL032W,1028,401,1429,3102,5762,806,
583,YBR054W,92,1338,1430,265,223,304,
584,YNL175C,846,588,1434,1084,2267,855,
585,YMR096W,1042,392,1434,1341,1243,649,
586,YGR292W,509,926,1435,792,1240,1073,
587,YIL123W,549,888,1437,456,770,409,
588,YNL031C,302,1136,1438,232,50,193,
589,YOR206W,441,1004,1445,790,511,737,
590,YGL148W,1060,386,1446,578,3068,449,
591,YIL133C,86,1364,1450,162,30,157,
592,YDL143W,720,732,1452,1100,2689,880,
593,YHR007C,722,731,1453,228,84,283,
594,YNL200C,792,662,1454,5374,5597,3070,
595,YFL028C,1055,399,1454,1638,1933,2215,
596,YBR299W,517,938,1455,778,1171,1076,
597,YHR092C,596,860,1456,170,8,268,
598,YBL028C,641,816,1457,686,773,498,
599,YLR208W,1150,311,1461,550,832,653,
600,YPL235W,502,959,1461,1361,608,761,
601,YLR429W,762,700,1462,2578,2887,1447,
602,YCR010C,744,722,1466,892,628,1218,
603,YER133W,568,904,1472,693,336,1465,
604,YNL134C,637,836,1473,956,2856,614,
605,YHL001W,67,1408,1475,153,64,70,
606,YJL001W,512,964,1476,1698,1929,1752,
607,YGL106W,876,601,1477,1524,5738,407,
608,YBL087C,139,1340,1479,185,211,204,
609,YEL046C,428,1052,1480,539,3930,472,
610,YOL012C,877,603,1480,2950,968,1661,
611,YPR145W,178,1303,1481,375,662,411,
612,YEL042W,666,815,1481,842,889,1138,
613,YJR048W,384,1098,1482,393,611,388,
614,YBL003C,330,1155,1485,220,2,242,
615,YDR394W,768,718,1486,1137,2944,856,
616,YHR008C,395,1091,1486,1618,5131,609,
617,YHR190W,1111,377,1488,547,1777,591,
618,YJR148W,1260,230,1490,1775,2590,837,
619,YNL098C,672,818,1490,2798,4663,1120,
620,YDL201W,780,714,1494,1408,2163,1053,
621,YGR218W,1058,440,1498,846,386,989,
622,YBR252W,916,583,1499,2266,4586,1137,
623,YPL197C,414,1086,1500,501,1181,2952,
624,YML079W,1036,472,1508,1762,1427,2187,
625,YPL145C,1026,482,1508,732,606,795,
626,YPR041W,492,1019,1511,498,733,543,
627,YDR408C,580,935,1515,6068,6173,1964,
628,YJL221C,926,590,1516,762,2297,833,
629,YCL001W,420,1097,1517,522,235,879,
630,YJL008C,860,658,1518,1012,833,818,
631,YER087C-B,1194,325,1519,2107,1089,1382,
632,YPR181C,1068,454,1522,1070,2997,899,
633,YHR074W,885,638,1523,1689,2219,1727,
634,YDR533C,1221,302,1523,729,508,920,
635,YJR133W,938,595,1533,556,966,499,
636,YOR142W,978,556,1534,819,464,764,
637,YDR224C,124,1410,1534,157,23,101,
638,YHR210C,797,738,1535,3210,4859,2580,
639,YKL211C,696,843,1539,2003,4277,1435,
640,YBR093C,294,1252,1546,274,650,404,
641,YER120W,1261,286,1547,1653,4196,860,
642,YML058W,530,1020,1550,649,2366,445,
643,YLR126C,915,635,1550,3701,2931,3699,
644,YPR036W-A,578,976,1554,960,4339,1225,
645,YML069W,660,900,1560,1079,897,1034,
646,YBL001C,1174,387,1561,763,723,750,
647,YDR516C,981,586,1567,3129,4878,1188,
648,YJR121W,852,727,1579,314,121,331,
649,YHR026W,437,1143,1580,711,1139,896,
650,YLR435W,501,1085,1586,845,795,623,
651,YER003C,368,1218,1586,544,477,546,
652,YIL172C,950,637,1587,760,2293,834,
653,YPL232W,1014,578,1592,2096,5564,823,
654,YGR267C,1089,504,1593,1111,981,1227,
655,YGR060W,522,1072,1594,222,161,408,
656,YIL070C,601,996,1597,1025,632,753,
657,YDR468C,711,887,1598,923,1221,1302,
658,YPR133W-A,589,1014,1603,1487,651,1186,
659,YGL187C,833,771,1604,554,340,895,
660,YDL236W,1278,329,1607,1284,1471,1192,
661,YGR167W,1038,569,1607,945,1357,625,
662,YLR325C,210,1402,1612,67,44,1,
663,YIL148W,271,1344,1615,64,77,122,
664,YNR050C,298,1318,1616,395,372,403,
665,YMR146C,1033,584,1617,553,1768,706,
666,YBL091C,1123,498,1621,1315,3634,921,
667,YER023W,1493,131,1624,1373,2234,1005,
668,YDR363W-A,1189,439,1628,788,658,835,
669,YJL014W,460,1173,1633,839,800,840,
670,YLR421C,438,1196,1634,1797,1344,2131,
671,YOR293W,358,1277,1635,3,37,42,
672,YDL110C,1110,525,1635,5213,6302,796,
673,YKL182W,1223,412,1635,346,250,370,
674,YNR032C-A,1243,394,1637,5260,4204,5185,
675,YGR211W,739,902,1641,897,2842,687,
676,YGL210W,513,1129,1642,2749,4226,2152,
677,YOR117W,989,653,1642,1559,1307,853,
678,YHR112C,1133,510,1643,2215,4118,2475,
679,YJL216C,606,1038,1644,759,1385,950,
680,YNR018W,775,871,1646,3931,5975,1419,
681,YPL171C,1002,646,1648,2093,4945,1113,
682,YAR002C-A,388,1263,1651,471,391,425,
683,YNL104C,1307,345,1652,581,1280,536,
684,YKR092C,976,678,1654,1277,3836,1416,
685,YML094W,896,759,1655,1804,1731,751,
686,YJL145W,873,783,1656,890,3272,928,
687,YNL070W,359,1298,1657,607,199,901,
688,YIL051C,817,846,1663,386,454,450,
689,YPL187W,1034,629,1663,614,187,474,
690,YPR191W,969,695,1664,1019,3406,733,
691,YMR083W,1202,467,1669,509,376,589,
692,YGL120C,974,706,1680,1233,1734,1019,
693,YNL036W,700,986,1686,1073,2502,1444,
694,YNL246W,540,1154,1694,5090,5761,1206,
695,YGL058W,456,1239,1695,674,449,619,
696,YPR149W,1286,410,1696,377,1031,696,
697,YHR046C,829,868,1697,2313,1634,2275,
698,YGL011C,812,885,1697,1496,1026,1388,
699,YMR229C,1197,501,1698,751,634,689,
700,YOR362C,818,881,1699,1801,3767,1635,
701,YDL131W,1291,409,1700,449,1422,540,
702,YGL137W,648,1055,1703,944,727,1072,
703,YDR033W,200,1505,1705,214,98,402,
704,YMR246W,712,995,1707,852,2045,838,
705,YER048C,1267,447,1714,1991,1744,720,
706,YNL071W,1596,119,1715,930,2269,522,
707,YMR241W,832,886,1718,430,314,530,
708,YDL147W,570,1148,1718,1834,1128,1202,
709,YOR243C,735,988,1723,1166,1053,815,
710,YJR014W,733,992,1725,1869,3723,558,
711,YHR018C,1083,647,1730,722,815,907,
712,YLR172C,897,834,1731,1388,3222,1031,
713,YKL001C,1196,536,1732,657,1103,642,
714,YPR187W,958,776,1734,803,589,521,
715,YKL024C,1211,524,1735,2142,5919,698,
716,YOL038W,990,747,1737,5073,5554,1862,
717,YHR137W,717,1028,1745,1889,2509,1543,
718,YNL287W,1012,733,1745,692,479,828,
719,YOR341W,961,787,1748,504,279,604,
720,YBR088C,1434,315,1749,586,1298,881,
721,YOL064C,1113,636,1749,1153,1425,1117,
722,YPL258C,1007,743,1750,1320,2624,1530,
723,YKL127W,934,817,1751,1110,1399,959,
724,YFL005W,1595,159,1754,1215,3793,1307,
725,YEL060C,823,933,1756,631,4809,468,
726,YBR010W,263,1493,1756,181,102,153,
727,YER026C,634,1124,1758,1251,925,1716,
728,YDL145C,849,909,1758,731,734,776,
729,YNL241C,1122,640,1762,4125,6128,1103,
730,YPR127W,1561,204,1765,946,3418,701,
731,YHR051W,1392,375,1767,678,317,575,
732,YGL234W,884,890,1774,697,1480,836,
733,YOR317W,979,799,1778,716,851,716,
734,YBR009C,269,1511,1780,125,103,156,
735,YDL212W,1304,476,1780,780,483,951,
736,YPL081W,256,1525,1781,268,241,137,
737,YKR080W,956,826,1782,1202,2732,1368,
738,YMR142C,321,1463,1784,98,43,24,
739,YLR196W,758,1027,1785,658,470,929,
740,YDR330W,413,1373,1786,3019,4279,1583,
741,YER052C,917,872,1789,590,678,933,
742,YHR182C-A,880,911,1791,596,5018,2569,
743,YAL044W-A,1509,283,1792,5401,6097,2010,
744,YFL010C,1398,398,1796,3619,3232,2688,
745,YAL036C,559,1238,1797,1263,3124,1279,
746,YKL145W,434,1367,1801,832,943,731,
747,YPL211W,888,913,1801,1138,351,1445,
748,YAL004W,514,1288,1802,1015,5996,5666,
749,YNR071C,1019,784,1803,899,2024,905,
750,YHR029C,872,932,1804,1913,1281,1785,
751,YPL091W,1663,142,1805,872,864,814,
752,YLR237W,612,1193,1805,408,757,694,
753,YGL103W,87,1721,1808,116,66,171,
754,YOL157C,977,833,1810,726,1865,732,
755,YEL013W,718,1092,1810,1247,441,1569,
756,YNL132W,1348,463,1811,743,682,829,
757,YDR178W,831,980,1811,1160,1658,1193,
758,YDL055C,41,1775,1816,166,167,172,
759,YLR406C,133,1686,1819,198,264,169,
760,YOR204W,1149,672,1821,385,1099,397,
761,YPL090C,77,1746,1823,43,135,8,
762,YJL217W,1134,689,1823,4061,3287,2462,
763,YIL138C,1546,278,1824,993,657,416,
764,YMR074C,1381,452,1833,793,1505,810,
765,YKL007W,835,998,1833,1431,3872,1412,
766,YPL094C,1093,740,1833,2097,4543,1295,
767,YLR068W,899,939,1838,1705,1524,451,
768,YBR155W,1158,680,1838,1795,1045,892,
769,YGL121C,759,1084,1843,3548,4177,1904,
770,YLR363C,684,1160,1844,636,242,1212,
771,YHR146W,1086,763,1849,2390,2141,977,
772,YKL103C,1041,810,1851,1959,4295,1134,
773,YCR009C,566,1285,1851,1059,1358,967,
774,YMR208W,1326,529,1855,1469,2113,1759,
775,YFR011C,801,1056,1857,1116,1093,629,
776,YOR061W,837,1021,1858,2002,3384,1253,
777,YER070W,484,1376,1860,464,461,511,
778,YDR177W,1230,631,1861,3256,3299,1793,
779,YBR034C,402,1461,1863,570,1881,626,
780,YPL260W,452,1413,1865,1354,1291,1417,
781,YBR046C,1265,604,1869,2660,2567,1843,
782,YGR049W,655,1220,1875,970,1113,1631,
783,YPR148C,1263,615,1878,2183,1388,1032,
784,YMR124W,1422,458,1880,3752,2834,2514,
785,YIR031C,1176,705,1881,954,1014,1211,
786,YDR034W-B,1117,765,1882,465,617,5792,
787,YLR304C,1318,580,1898,278,82,297,
788,YML125C,1071,830,1901,1409,4649,1116,
789,YDR212W,1468,434,1902,703,590,669,
790,YGL048C,1222,683,1905,937,1371,867,
791,YBL050W,511,1394,1905,2828,2378,2000,
792,YPL266W,1022,884,1906,1915,1578,1223,
793,YER007C-A,1447,460,1907,834,627,821,
794,YGL255W,435,1474,1909,579,655,1427,
795,YHR104W,1598,312,1910,910,1746,903,
796,YBR160W,671,1240,1911,2038,3988,1786,
797,YOR251C,1570,347,1917,2764,3190,2106,
798,YML093W,389,1529,1918,901,970,605,
799,YBR085W,76,1842,1918,1062,752,1411,
800,YPL143W,216,1702,1918,107,432,138,
801,YER044C,1073,851,1924,330,289,423,
802,YEL027W,854,1071,1925,212,15,323,
803,YMR271C,1798,130,1928,4411,2527,2389,
804,YNL030W,352,1580,1932,180,153,178,
805,YOR271C,1155,779,1934,2485,5325,1401,
806,YNL202W,1139,795,1934,4328,4038,1485,
807,YNL145W,858,1080,1938,682,4919,563,
808,YGR024C,1224,715,1939,2720,2185,3191,
809,YDR412W,1049,893,1942,3219,4395,1167,
810,YMR110C,991,954,1945,1700,1250,2560,
811,YBL002W,128,1820,1948,230,62,154,
812,YBL057C,1094,855,1949,4299,2060,2243,
813,YOR272W,1337,613,1950,1122,1874,1027,
814,YNL113W,752,1200,1952,1248,2227,1140,
815,YFL034C-A,314,1639,1953,461,951,432,
816,YGL258W,848,1105,1953,338,364,531,
817,YIL162W,692,1262,1954,440,597,597,
818,YDL086W,1761,194,1955,3489,5914,1441,
819,YLR348C,1177,780,1957,5576,5900,2038,
820,YHL040C,490,1468,1958,670,717,1154,
821,YER012W,1238,721,1959,1245,1121,791,
822,YMR194W,232,1733,1965,161,348,125,
823,YNL138W,1733,235,1968,962,740,790,
824,YNL061W,935,1037,1972,702,567,600,
825,YGR234W,1056,917,1973,569,408,582,
826,YHR215W,554,1420,1974,424,1583,634,
827,YLR335W,760,1215,1975,3609,2348,1926,
828,YLR420W,802,1175,1977,2630,1461,2191,
829,YER174C,984,994,1978,3228,2693,2257,
830,YPR073C,1292,690,1982,775,685,1645,
831,YDR382W,471,1513,1984,86,5,44,
832,YDR372C,1607,380,1987,1072,728,975,
833,YOR010C,427,1566,1993,238,158,227,
834,YGR054W,1013,981,1994,908,1420,968,
835,YBL076C,1530,465,1995,381,349,412,
836,YLR380W,1214,782,1996,911,5461,779,
837,YNL281W,738,1258,1996,2004,4324,974,
838,YLR174W,814,1187,2001,2034,2700,952,
839,YLR078C,954,1049,2003,2731,2426,1654,
840,YHL011C,1312,691,2003,754,743,875,
841,YKL096W,211,1793,2004,712,1603,524,
842,YCL057C-A,1298,708,2006,5246,6306,1142,
843,YNR001C,909,1101,2010,659,300,735,
844,YJR099W,1333,679,2012,5154,2678,3274,
845,YER048W-A,1340,673,2013,826,715,564,
846,YDR513W,1403,610,2013,961,1159,576,
847,YPR168W,871,1146,2017,669,1366,583,
848,YML012W,799,1219,2018,1690,4241,607,
849,YDR429C,1784,237,2021,689,407,547,
850,YNL215W,1075,948,2023,4833,4804,2372,
851,YLR029C,364,1661,2025,69,181,113,
852,YIL118W,959,1066,2025,1621,3073,2413,
853,YNL333W,690,1339,2029,1687,3947,652,
854,YBR085C-A,1345,684,2029,2510,2404,1348,
855,YPR010C,892,1138,2030,841,749,1052,
856,YGR132C,842,1191,2033,1234,1712,734,
857,YPR173C,1128,907,2035,3131,2821,1437,
858,YDL060W,1032,1009,2041,1575,1931,1105,
859,YNR034W-A,664,1379,2043,2334,2647,1311,
860,YMR295C,1216,828,2044,885,2625,852,
861,YOR151C,1109,936,2045,740,440,994,
862,YOR122C,784,1266,2050,288,146,271,
863,YJL179W,1248,803,2051,1499,516,1112,
864,YKR066C,1231,821,2052,2956,5535,1258,
865,YAR071W,508,1546,2054,414,1539,632,
866,YBR145W,614,1441,2055,633,420,774,
867,YDR483W,1571,491,2062,548,575,766,
868,YPL146C,652,1412,2064,928,341,736,
869,YFL059W,584,1484,2068,1696,4141,627,
870,YBR222C,843,1226,2069,1760,4723,1148,
871,YDR361C,1215,859,2074,865,1198,1252,
872,YKL085W,898,1183,2081,567,1619,382,
873,YOR157C,1358,725,2083,2030,1791,1471,
874,YGR026W,881,1204,2085,875,1523,1222,
875,YER006W,170,1915,2085,951,668,912,
876,YBR283C,1693,393,2086,535,572,567,
877,YLR347C,1040,1047,2087,1197,903,1231,
878,YGR154C,1023,1065,2088,2879,3048,1576,
879,YDL181W,1657,432,2089,6241,6110,1495,
880,YPR058W,1437,652,2089,3539,2038,2399,
881,YMR307W,919,1174,2093,335,296,492,
882,YGL018C,643,1452,2095,1390,3323,1473,
883,YLR295C,1593,508,2101,849,569,923,
884,YLR387C,544,1558,2102,1779,1838,1563,
885,YJL010C,986,1117,2103,1770,1066,1310,
886,YER178W,1074,1030,2104,594,1105,542,
887,YPL273W,1722,385,2107,1051,2034,1123,
888,YDR346C,966,1142,2108,609,568,618,
889,YDL226C,1416,692,2108,3636,3611,3657,
890,YNL160W,479,1632,2111,290,527,345,
891,YDL021W,821,1292,2113,1491,1846,1510,
892,YEL051W,679,1436,2115,493,217,406,
893,YJR135W-A,863,1256,2119,1298,3265,1326,
894,YER056C,426,1697,2123,864,602,1358,
895,YEL037C,1361,762,2123,3819,3725,1519,
896,YNR064C,683,1445,2128,1949,3661,2225,
897,YOL057W,1161,973,2134,1656,1815,1758,
898,YIR022W,953,1182,2135,3621,4973,1392,
899,YDR152W,930,1207,2137,1794,2774,869,
900,YDL031W,931,1208,2139,1283,1048,1081,
901,YBR261C,1245,898,2143,5450,6013,2538,
902,YMR298W,1384,760,2144,1003,1954,1357,
903,YLR178C,1799,346,2145,5117,5825,1856,
904,YGR116W,1078,1067,2145,776,783,1037,
905,YGR103W,458,1688,2146,571,437,537,
906,YOL083W,770,1380,2150,3889,3693,2649,
907,YDL126C,1127,1024,2151,486,382,414,
908,YAR073W,1164,987,2151,582,1252,672,
909,YGL242C,1490,667,2157,1212,1175,1324,
910,YMR251W-A,387,1770,2157,363,352,410,
911,YPR062W,1284,875,2159,2470,4100,1183,
912,YJL033W,731,1429,2160,1099,667,1045,
913,YOR239W,697,1467,2164,882,640,552,
914,YMR300C,1115,1051,2166,719,547,886,
915,YMR105C,560,1613,2173,475,656,520,
916,YHR096C,1057,1118,2175,1175,1860,1196,
917,YAL007C,1087,1089,2176,783,811,851,
918,YDL103C,1524,655,2179,1790,2854,1198,
919,YLR229C,1864,317,2181,2640,2134,3189,
920,YBR177C,1188,993,2181,2036,2329,2086,
921,YKL016C,1410,772,2182,974,2321,668,
922,YGR273C,651,1531,2182,2590,1379,2079,
923,YIR042C,764,1419,2183,4495,2907,2471,
924,YJL030W,1008,1178,2186,4938,3844,4174,
925,YKL216W,1137,1050,2187,700,870,918,
926,YBR135W,1264,923,2187,5517,5862,1720,
927,YKR081C,960,1232,2192,807,937,651,
928,YPL142C,1009,1189,2198,886,3459,3542,
929,YBL047C,1289,920,2209,1213,868,1060,
930,YMR038C,1637,572,2209,3870,5938,1983,
931,YGR175C,693,1521,2214,287,265,348,
932,YGR173W,529,1690,2219,1097,729,1177,
933,YKL029C,1088,1131,2219,1363,4963,789,
934,YJL020C,538,1684,2222,4671,3066,2401,
935,YDR341C,1466,756,2222,526,399,463,
936,YOR091W,561,1662,2223,1589,5545,758,
937,YKL040C,1233,990,2223,1127,1236,1025,
938,YDL164C,461,1765,2226,2308,2146,1869,
939,YOR234C,202,2026,2228,111,131,106,
940,YER015W,537,1692,2229,2109,1528,1822,
941,YGL238W,616,1616,2232,977,481,1339,
942,YCL064C,661,1571,2232,1855,1484,2044,
943,YDR304C,1619,617,2236,650,2926,613,
944,YHR009C,633,1606,2239,2447,4381,2574,
945,YLL039C,267,1976,2243,563,1697,448,
946,YGR148C,147,2097,2244,112,176,11,
947,YDR388W,1512,734,2246,2535,2408,1029,
948,YGR177C,763,1483,2246,2076,4789,2576,
949,YOL145C,338,1913,2251,1231,804,1221,
950,YKR070W,1156,1095,2251,2707,2615,2402,
951,YGR152C,980,1273,2253,3512,2861,2156,
952,YGL102C,525,1729,2254,794,5017,4956,
953,YJL173C,1737,520,2257,4488,4820,1537,
954,YDR074W,936,1322,2258,705,921,1107,
955,YKL069W,1728,532,2260,1214,1458,1683,
956,YJL133C-A,994,1267,2261,1106,5056,873,
957,YNL124W,788,1473,2261,3891,5091,2006,
958,YOR009W,433,1830,2263,417,750,603,
959,YBL108C-A,43,2220,2263,279,2028,338,
960,YML105C,1407,857,2264,1727,1932,914,
961,YHR037W,1085,1184,2269,1324,1202,1318,
962,YNL069C,326,1943,2269,108,122,86,
963,YJL111W,1393,876,2269,1167,492,995,
964,YBL075C,1625,645,2270,2131,1163,1038,
965,YOL133W,1346,925,2271,859,761,1233,
966,YKL067W,1021,1250,2271,810,431,684,
967,YGL112C,732,1541,2273,3112,1570,2074,
968,YER055C,1469,805,2274,1426,1560,1405,
969,YLR186W,1220,1058,2278,1219,3022,1647,
970,YCL050C,680,1600,2280,387,453,554,
971,YBL018C,347,1941,2288,1200,692,2398,
972,YGL040C,810,1490,2300,1532,2014,1744,
973,YGL078C,1603,697,2300,589,484,477,
974,YML129C,1183,1121,2304,1543,1302,2020,
975,YGR082W,1450,854,2304,957,1265,685,
976,YGR286C,910,1396,2306,906,950,982,
977,YJR095W,1374,934,2308,996,840,813,
978,YDL099W,1001,1307,2308,3399,1174,937,
979,YOR283W,1720,591,2311,698,698,824,
980,YPL250W-A,539,1773,2312,1272,5400,4922,
981,YOL067C,472,1841,2313,6092,6415,2198,
982,YLL056C,557,1758,2315,3222,3401,2033,
983,YAL062W,1645,674,2319,5265,5883,930,
984,YBR265W,1151,1168,2319,4768,5639,2376,
985,YKR076W,1160,1162,2322,1036,2849,1243,
986,YOL123W,650,1674,2324,616,735,788,
987,YLR287C,1101,1224,2325,2714,1730,2076,
988,YGR181W,1029,1296,2325,1436,1926,726,
989,YER072W,1849,477,2326,3123,3253,3471,
990,YDL046W,1059,1268,2327,1128,3967,725,
991,YDL125C,1386,943,2329,895,2488,773,
992,YLL026W,1874,459,2333,506,534,442,
993,YAL037C-B,1356,983,2339,537,5030,2748,
994,YDL015C,1846,495,2341,555,485,965,
995,YIR001C,1341,1002,2343,2668,3490,1871,
996,YBR117C,1753,593,2346,2867,3626,1902,
997,YMR261C,783,1565,2348,1088,1474,1496,
998,YKL157W,1400,949,2349,782,663,820,
999,YOL071W,1520,829,2349,4173,5456,1509,
1000,YDR165W,1497,853,2350,932,722,1379,
1001,YKL153W,1213,1140,2353,651,5058,3397,
1002,YJL045W,704,1649,2353,2758,2464,1180,
1003,YLR328W,1165,1188,2353,938,908,1204,
1004,YDR087C,1651,703,2354,2546,3826,1642,
1005,YMR092C,1518,838,2356,1318,1511,1579,
1006,YLR344W,249,2108,2357,186,306,97,
1007,YNL052W,1250,1108,2358,2025,2889,1628,
1008,YDR398W,644,1714,2358,2350,3466,1256,
1009,YDL235C,405,1957,2362,1016,1177,1169,
1010,YLR074C,1035,1330,2365,5690,5885,2882,
1011,YDR381W,485,1883,2368,587,1213,400,
1012,YIL109C,1564,804,2368,1049,1848,1201,
1013,YGL200C,795,1575,2370,1340,5267,1015,
1014,YAR007C,635,1738,2373,968,1442,1178,
1015,YGR088W,153,2222,2375,708,1033,1068,
1016,YKL192C,2142,234,2376,1763,5692,780,
1017,YMR041C,1436,941,2377,3632,3457,2541,
1018,YOL005C,2098,281,2379,5642,6445,2043,
1019,YOR150W,1274,1107,2381,2923,3006,1881,
1020,YDL130W,418,1963,2381,114,101,51,
1021,YDR342C,1247,1137,2384,227,52,282,
1022,YOL097C,2019,367,2386,561,1013,571,
1023,YEL020C,800,1588,2388,5467,5563,3677,
1024,YHR216W,747,1642,2389,508,794,527,
1025,YOR284W,615,1776,2391,3451,3400,3717,
1026,YGR162W,1299,1096,2395,663,653,551,
1027,YHR213W,626,1769,2395,684,693,1271,
1028,YOR187W,1442,956,2398,515,387,515,
1029,YBL041W,1527,873,2400,2755,2479,1682,
1030,YMR203W,1907,503,2410,595,458,666,
1031,YBR162C,1061,1349,2410,350,320,555,
1032,YOR387C,1376,1035,2411,368,374,579,
1033,YDR276C,354,2058,2412,384,1642,654,
1034,YDL198C,1979,445,2424,1196,2181,1200,
1035,YOL156W,757,1669,2426,2446,4375,1633,
1036,YCR088W,1234,1194,2428,1206,2053,640,
1037,YJL172W,972,1459,2431,694,1257,910,
1038,YKR042W,865,1568,2433,284,1032,289,
1039,YHR039C,734,1700,2434,830,643,1213,
1040,YKL167C,787,1658,2445,1791,1949,1898,
1041,YDR427W,1385,1061,2446,603,381,1109,
1042,YDR367W,1411,1036,2447,1518,1084,3380,
1043,YOR153W,1181,1272,2453,638,501,962,
1044,YIL160C,1180,1281,2461,5209,5321,2201,
1045,YBR020W,1144,1319,2463,1304,1554,1143,
1046,YLR038C,546,1918,2464,344,143,690,
1047,YKR001C,1937,531,2468,665,535,657,
1048,YFL030W,1394,1076,2470,5698,5910,3371,
1049,YDL225W,1099,1374,2473,1274,947,902,
1050,YDL193W,918,1555,2473,1174,1037,961,
1051,YPR192W,1568,910,2478,3675,5576,1497,
1052,YCR036W,1046,1433,2479,1902,2252,2474,
1053,YLR321C,967,1512,2479,1346,2460,1299,
1054,YLR021W,1252,1227,2479,3518,3631,2640,
1055,YIR036C,1018,1462,2480,6508,6539,4385,
1056,YPR036W,2130,352,2482,2978,6127,985,
1057,YKL196C,2066,416,2482,1781,1228,1041,
1058,YMR200W,588,1897,2485,1562,1245,2503,
1059,YGL099W,1529,957,2486,1126,550,1018,
1060,YPL111W,1091,1397,2488,1433,3961,1089,
1061,YGR111W,1525,965,2490,2410,2670,2594,
1062,YKR006C,1178,1321,2499,2051,2078,894,
1063,YKR035W-A,1402,1099,2501,4384,4363,1486,
1064,YGL067W,1701,801,2502,2620,2738,2338,
1065,YKL006W,57,2447,2504,152,114,50,
1066,YOR155C,1372,1134,2506,4197,4187,2956,
1067,YOL077C,2071,438,2509,721,585,801,
1068,YFR010W,1725,785,2510,981,638,1004,
1069,YOL052C,541,1969,2510,2381,5730,1804,
1070,YDR091C,1893,619,2512,340,140,469,
1071,YDL205C,942,1570,2512,1905,3696,1395,
1072,YHR058C,946,1567,2513,3726,4518,3696,
1073,YML025C,1235,1280,2515,3046,3436,1675,
1074,YFL038C,2388,127,2515,2995,6170,1136,
1075,YJL151C,975,1540,2515,4194,6193,3125,
1076,YEL012W,2032,487,2519,3104,3777,3567,
1077,YJR158W,1504,1015,2519,2046,2811,2511,
1078,YJL117W,1827,693,2520,1627,3622,1700,
1079,YNL117W,1683,841,2524,997,1616,979,
1080,YMR322C,1508,1016,2524,3289,4545,1648,
1081,YDL245C,1519,1007,2526,2053,2795,2526,
1082,YLL034C,1031,1496,2527,1878,987,1249,
1083,YER128W,1320,1211,2531,2756,3473,4066,
1084,YOL154W,567,1964,2531,411,469,741,
1085,YDR529C,1179,1357,2536,1831,3763,862,
1086,YDR111C,962,1576,2538,3558,3342,1913,
1087,YIL008W,2112,426,2538,795,2233,964,
1088,YGR229C,1185,1354,2539,1124,679,1168,
1089,YJR076C,1580,960,2540,2340,3589,1199,
1090,YLR062C,591,1953,2544,746,5653,5575,
1091,YGL195W,1277,1269,2546,1330,1118,1119,
1092,YHR117W,1631,915,2546,3094,3354,1566,
1093,YCL054W,1987,559,2546,629,473,465,
1094,YPL134C,1079,1470,2549,5440,5243,3003,
1095,YOR042W,1902,649,2551,5104,5211,1812,
1096,YBL068W-A,1438,1114,2552,583,895,662,
1097,YNL323W,463,2090,2553,2796,1725,2272,
1098,YLR259C,911,1644,2555,376,283,308,
1099,YPL278C,1315,1244,2559,914,2133,2353,
1100,YIL021W,971,1589,2560,1628,1278,2056,
1101,YNL335W,1973,587,2560,4891,5111,3418,
1102,YPR172W,2137,425,2562,2050,3112,1882,
1103,YCR043C,1432,1135,2567,843,931,4416,
1104,YDR472W,773,1794,2567,4240,3815,4983,
1105,YNL189W,1362,1206,2568,516,272,676,
1106,YDR188W,1503,1069,2572,4172,5927,946,
1107,YGR205W,1859,713,2572,1953,4517,1877,
1108,YPL010W,2088,486,2574,1660,1519,1254,
1109,YDL178W,1259,1317,2576,1169,849,1296,
1110,YDR202C,495,2084,2579,2094,3209,4243,
1111,YHR108W,1397,1185,2582,1342,1611,1158,
1112,YFL018C,1409,1181,2590,717,1361,497,
1113,YJL081C,851,1739,2590,4032,2372,2942,
1114,YDL215C,1767,823,2590,984,881,1153,
1115,YER011W,213,2378,2591,176,22,181,
1116,YIL039W,1588,1003,2591,813,1135,1743,
1117,YLR268W,1939,660,2599,1404,4673,1811,
1118,YDR343C,1351,1249,2600,226,46,284,
1119,YOL126C,793,1808,2601,1513,4262,1157,
1120,YLR361C-A,2138,464,2602,4658,2482,2301,
1121,YMR080C,1726,877,2603,1061,1200,1301,
1122,YOL006C,565,2039,2604,1548,1549,1080,
1123,YEL024W,807,1806,2613,400,194,622,
1124,YMR084W,869,1745,2614,2478,3660,2280,
1125,YLR200W,2168,448,2616,3037,1573,641,
1126,YJR072C,1867,751,2618,3018,5489,1322,
1127,YNL290W,745,1879,2624,5803,6057,3145,
1128,YNR055C,674,1952,2626,1159,2009,1551,
1129,YBR256C,727,1900,2627,1703,4019,1708,
1130,YGL087C,1674,953,2627,735,1674,1146,
1131,YER090W,1477,1151,2628,933,644,1011,
1132,YCL028W,2552,76,2628,1694,2443,1210,
1133,YGR266W,736,1893,2629,1641,2171,1873,
1134,YDR539W,552,2078,2630,2138,1090,2237,
1135,YBR298C,636,1996,2632,1891,1067,2414,
1136,YCL030C,2027,607,2634,690,1115,661,
1137,YIL142W,1280,1355,2635,2069,4129,1418,
1138,YOR209C,1441,1195,2636,964,983,1098,
1139,YGR244C,1723,914,2637,1581,1979,1016,
1140,YMR188C,1353,1284,2637,3761,2231,1585,
1141,YMR292W,1102,1538,2640,4083,3113,3415,
1142,YJL164C,1633,1008,2641,1557,1786,1457,
1143,YLR113W,1794,848,2642,2016,2901,1361,
1144,YGR246C,824,1819,2643,1666,1249,1220,
1145,YPL280W,1590,1059,2649,3577,4617,1764,
1146,YFL011W,932,1717,2649,2054,2310,1722,
1147,YFR007W,878,1771,2649,2651,3383,2782,
1148,YGR078C,765,1886,2651,5735,6383,2167,
1149,YER134C,920,1734,2654,3393,4136,4954,
1150,YLR168C,390,2267,2657,1054,1148,1582,
1151,YMR290C,1584,1078,2662,785,418,748,
1152,YOR136W,1459,1203,2662,725,623,945,
1153,YDL157C,1700,963,2663,867,385,809,
1154,YGR231C,1257,1407,2664,2686,1527,1391,
1155,YLL023C,1954,712,2666,1290,5403,1594,
1156,YDL064W,992,1677,2669,1348,388,2492,
1157,YGL213C,1587,1083,2670,1397,598,2337,
1158,YOR252W,1789,883,2672,2210,3489,1104,
1159,YPL078C,1865,808,2673,646,471,476,
1160,YJL143W,948,1726,2674,1934,778,2884,
1161,YNR051C,847,1827,2674,1603,1878,940,
1162,YGR135W,1897,778,2675,1450,1383,1294,
1163,YJR077C,1895,781,2676,490,2574,371,
1164,YDR293C,1244,1437,2681,1378,1306,1272,
1165,YLL041C,1190,1495,2685,1001,1318,1634,
1166,YER089C,1704,982,2686,5208,6124,2555,
1167,YJL036W,638,2048,2686,2911,3041,2246,
1168,YDR014W-A,1721,969,2690,4646,5070,2431,
1169,YKL120W,1262,1428,2690,1275,648,1203,
1170,YBR092C,1205,1486,2691,371,1085,456,
1171,YOL016C,1143,1548,2691,2464,2605,1603,
1172,YBR208C,1717,978,2695,1258,858,1267,
1173,YLR276C,748,1947,2695,1360,1157,1355,
1174,YDL130W-A,2012,685,2697,2492,3541,1768,
1175,YCL025C,900,1797,2697,824,1330,966,
1176,YCR063W,743,1954,2697,5781,6462,2023,
1177,YDL153C,1272,1426,2698,917,774,637,
1178,YLR401C,1136,1563,2699,2462,4371,1448,
1179,YIL145C,947,1752,2699,5476,5657,4114,
1180,YPL243W,999,1708,2707,1649,1899,1410,
1181,YDR519W,1076,1633,2709,1066,788,1078,
1182,YML108W,1646,1064,2710,749,1364,1174,
1183,YLR248W,1350,1361,2711,1859,2642,1474,
1184,YDR273W,1672,1042,2714,4293,4043,1297,
1185,YIR034C,1820,897,2717,1069,1639,1246,
1186,YOR327C,2313,406,2719,1147,2477,639,
1187,YGL065C,1203,1516,2719,1473,982,1578,
1188,YJR142W,1232,1488,2720,2743,2355,1546,
1189,YGL054C,1731,989,2720,357,274,656,
1190,YFL061W,2106,614,2720,4927,5075,3499,
1191,YJR022W,941,1780,2721,3287,5840,2685,
1192,YIL124W,1273,1458,2731,1573,1259,1602,
1193,YOR281C,1819,916,2735,1857,2170,1414,
1194,YIL171W,997,1743,2740,1512,2728,2601,
1195,YDL182W,1850,891,2741,502,2953,519,
1196,YGL019W,1614,1127,2741,5834,5660,2678,
1197,YNL156C,970,1772,2742,2947,3316,3317,
1198,YBL056W,1549,1197,2746,1413,910,1638,
1199,YIL040W,1147,1604,2751,987,1613,1251,
1200,YMR323W,1424,1329,2753,3634,5475,1815,
1201,YPL093W,933,1823,2756,383,519,364,
1202,YGL002W,1146,1611,2757,1652,2958,1855,
1203,YKR084C,1567,1190,2757,2871,2244,2668,
1204,YHL015W-A,1207,1551,2758,625,1337,528,
1205,YLR384C,1964,796,2760,1537,1483,1262,
1206,YJR064W,1963,797,2760,1000,1130,778,
1207,YGL053W,1462,1299,2761,4118,5418,4628,
1208,YLR314C,1715,1046,2761,1819,2816,1124,
1209,YOR089C,1484,1279,2763,3313,2858,1609,
1210,YDR424C,1426,1337,2763,2865,5151,1402,
1211,YJR159W,466,2304,2770,1161,2655,976,
1212,YNR054C,955,1816,2771,2723,4898,1170,
1213,YIL013C,478,2294,2772,1176,1596,1819,
1214,YNL149C,2346,429,2775,1193,1445,800,
1215,YJL074C,1063,1715,2778,1484,1491,1209,
1216,YPL281C,1485,1294,2779,3442,5357,1678,
1217,YGL244W,550,2231,2781,1645,1990,811,
1218,YOL094C,425,2358,2783,2870,3143,2344,
1219,YCR054C,1640,1144,2784,1954,2164,2667,
1220,YDR272W,1652,1133,2785,2945,1667,1242,
1221,YOR261C,1423,1362,2785,1090,874,1127,
1222,YOR393W,1492,1293,2785,3443,5352,1677,
1223,YKL094W,1327,1460,2787,3556,4914,1857,
1224,YML055W,1499,1289,2788,2613,2612,1850,
1225,YJL198W,1246,1543,2789,2170,3503,1588,
1226,YIR026C,1960,831,2791,2885,4342,1949,
1227,YBR062C,1842,952,2794,3491,1972,5896,
1228,YCR098C,1378,1416,2794,889,517,1713,
1229,YFR030W,1971,825,2796,724,666,608,
1230,YEL034C-A,786,2011,2797,1005,5198,5210,
1231,YML128C,1860,937,2797,863,3980,713,
1232,YEL066W,1755,1044,2799,4863,5815,2102,
1233,YNR035C,2294,505,2799,1218,4026,783,
1234,YBR101C,1236,1569,2805,1975,2694,2042,
1235,YEL032W,1290,1515,2805,2329,3954,1273,
1236,YCR060W,2263,544,2807,6611,6544,4873,
1237,YGR204W,2107,702,2809,801,3504,512,
1238,YGR191W,383,2429,2812,1185,891,1611,
1239,YER094C,2219,594,2813,4700,5995,2527,
1240,YOR101W,790,2024,2814,2229,3679,2706,
1241,YGR248W,2241,573,2814,5082,5593,2496,
1242,YHR063C,1241,1574,2815,884,504,865,
1243,YJL055W,2359,457,2816,3860,4202,1367,
1244,YPR004C,1108,1719,2827,3372,1837,2384,
1245,YMR121C,311,2517,2828,322,1098,236,
1246,YOR367W,1817,1011,2828,1990,596,2014,
1247,YLR008C,1543,1286,2829,1586,503,1329,
1248,YOR265W,2585,244,2829,3907,1868,1100,
1249,YJL123C,1258,1582,2840,3377,3785,1483,
1250,YHR088W,1295,1545,2840,1566,2161,1036,
1251,YJL109C,515,2327,2842,1443,1205,1733,
1252,YDR189W,1605,1237,2842,1317,2316,1139,
1253,YJL219W,1173,1673,2846,2409,4529,1697,
1254,YAL025C,1383,1464,2847,1093,2430,673,
1255,YBL026W,1911,940,2851,1108,1172,1106,
1256,YPL058C,1782,1070,2852,470,193,711,
1257,YML123C,1255,1597,2852,266,163,457,
1258,YKL135C,667,2187,2854,2256,1285,2440,
1259,YGL008C,2688,174,2862,70,7,124,
1260,YOR232W,2311,553,2864,667,319,429,
1261,YOR259C,1787,1077,2864,1325,1555,763,
1262,YGR157W,1389,1476,2865,1098,558,2158,
1263,YLR194C,820,2050,2870,5497,5529,3525,
1264,YEL001C,2026,845,2871,1908,1811,1814,
1265,YHR047C,2484,390,2874,866,803,715,
1266,YDR496C,2033,842,2875,619,396,671,
1267,YKL128C,1644,1233,2877,3922,4034,3088,
1268,YJR063W,2472,407,2879,1276,2379,1476,
1269,YER063W,1638,1245,2883,1680,2314,870,
1270,YDL141W,808,2081,2889,3197,2995,4781,
1271,YHR027C,2053,840,2893,1017,581,906,
1272,YOR125C,1103,1791,2894,2248,2323,1500,
1273,YOL049W,1773,1122,2895,2984,1690,1772,
1274,YML078W,1159,1736,2895,487,654,415,
1275,YKL151C,1940,958,2898,4389,5096,2319,
1276,YPL028W,531,2368,2899,379,238,369,
1277,YBR273C,1443,1456,2899,4454,4885,2171,
1278,YDL246C,535,2364,2899,1133,2664,991,
1279,YNL247W,2281,618,2899,597,539,513,
1280,YER117W,191,2711,2902,145,24,174,
1281,YKL091C,1141,1767,2908,1302,2436,2031,
1282,YOR006C,914,1994,2908,3649,2832,2704,
1283,YGL153W,1192,1718,2910,3928,3904,1557,
1284,YOL158C,749,2165,2914,5763,5861,5302,
1285,YGR277C,1643,1276,2919,5589,5654,3987,
1286,YIL026C,417,2503,2920,1827,2207,1907,
1287,YML070W,1974,947,2921,1024,957,686,
1288,YBR286W,874,2049,2923,399,1412,417,
1289,YBR248C,1813,1110,2923,2574,2621,1649,
1290,YBR080C,1925,1001,2926,1132,1075,1336,
1291,YGL012W,2082,847,2929,779,1258,1085,
1292,YPL234C,803,2127,2930,947,1906,1691,
1293,YER073W,1025,1911,2936,1223,2005,781,
1294,YOR041C,1349,1587,2936,2422,3557,1739,
1295,YLR056W,668,2277,2945,847,4009,1006,
1296,YGR275W,2302,643,2945,5081,3846,2953,
1297,YDR119W-A,949,1998,2947,1184,1235,1750,
1298,YMR152W,1696,1254,2950,747,1273,775,
1299,YGL154C,1528,1423,2951,3559,3419,2415,
1300,YDL174C,1760,1192,2952,1488,4260,1065,
1301,YJL066C,1354,1599,2953,3879,5620,2080,
1302,YKL026C,2096,858,2954,3282,3886,3969,
1303,YFR015C,1227,1731,2958,1551,3152,1259,
1304,YDR016C,1975,984,2959,5566,4899,3952,
1305,YJL124C,1305,1656,2961,2104,5228,1738,
1306,YER143W,1296,1666,2962,4801,4605,2639,
1307,YOR222W,1229,1735,2964,1683,3160,1689,
1308,YMR308C,1387,1581,2968,1294,738,1529,
1309,YOR326W,1547,1422,2969,1171,1076,1044,
1310,YBL082C,1866,1106,2972,6076,6340,4965,
1311,YPL024W,698,2276,2974,4456,4612,2256,
1312,YGR080W,1743,1231,2974,4526,4711,2981,
1313,YGL080W,1184,1792,2976,3569,1807,2364,
1314,YJR143C,2339,639,2978,854,1028,1207,
1315,YOR071C,1080,1899,2979,488,1062,927,
1316,YPL117C,2350,641,2991,476,254,882,
1317,YPL125W,1120,1889,3009,1528,850,1725,
1318,YCR007C,1629,1381,3010,2400,1204,3447,
1319,YBL064C,2440,571,3011,1230,2864,953,
1320,YNL292W,1871,1141,3012,4649,3375,2125,
1321,YNL014W,2031,985,3016,2220,1255,1550,
1322,YDR426C,1242,1777,3019,542,463,1866,
1323,YLR262C,1611,1411,3022,2049,566,1482,
1324,YJL188C,1319,1709,3028,1279,624,5793,
1325,YLR292C,1661,1368,3029,2505,1459,2531,
1326,YML035C,1269,1760,3029,1382,1608,1481,
1327,YGR123C,1523,1507,3030,1339,713,1833,
1328,YNR021W,2058,974,3032,645,1222,754,
1329,YER112W,1632,1403,3035,599,2800,1462,
1330,YOR163W,2017,1029,3046,2011,3121,1574,
1331,YHR085W,608,2439,3047,5226,4913,5696,
1332,YDR399W,1256,1796,3052,598,1295,428,
1333,YPL065W,598,2456,3054,1745,2565,1837,
1334,YBR096W,2433,623,3056,936,2082,1621,
1335,YHR072W,985,2072,3057,2962,3574,3511,
1336,YJR103W,890,2168,3058,4249,5712,2135,
1337,YNL110C,2060,999,3059,1466,799,935,
1338,YCR059C,1951,1109,3060,5680,6479,1845,
1339,YMR314W,2212,849,3061,4101,5156,1676,
1340,YLR118C,1366,1696,3062,2499,834,2362,
1341,YMR145C,1680,1382,3062,668,754,679,
1342,YNL088W,1371,1691,3062,1462,854,1586,
1343,YGR200C,391,2673,3064,1222,592,1659,
1344,YOL056W,1417,1648,3065,3206,3850,1491,
1345,YLR433C,719,2349,3068,2195,2215,2502,
1346,YDL190C,1209,1859,3068,1578,1686,1696,
1347,YKL184W,1856,1213,3069,1631,1701,2088,
1348,YPL245W,1439,1636,3075,2500,4680,1288,
1349,YNL264C,1559,1517,3076,1041,1888,2130,
1350,YBR236C,1081,1995,3076,2573,1915,1828,
1351,YEL063C,1152,1927,3079,850,942,794,
1352,YBR281C,836,2243,3079,1316,841,1799,
1353,YLL053C,714,2367,3081,453,350,660,
1354,YLR395C,1343,1740,3083,677,639,805,
1355,YHR094C,1126,1965,3091,300,247,478,
1356,YPR193C,737,2354,3091,2092,4383,1327,
1357,YCR077C,1461,1630,3091,2214,3887,1156,
1358,YBR019C,2161,944,3105,1444,1348,1559,
1359,YBR263W,2752,355,3107,637,2071,569,
1360,YIR004W,1806,1302,3108,3298,1694,1062,
1361,YGL207W,1486,1629,3115,941,751,1064,
1362,YCR016W,1692,1424,3116,2079,1983,1374,
1363,YKL193C,2255,866,3121,1738,3108,1763,
1364,YER180C-A,2722,403,3125,5734,4768,1619,
1365,YIL009W,769,2359,3128,1021,1541,1345,
1366,YLR017W,1978,1152,3130,1452,3353,1179,
1367,YGR264C,2596,535,3131,454,150,636,
1368,YMR237W,1608,1527,3135,2310,3229,1887,
1369,YJR068W,1986,1149,3135,1755,1789,1316,
1370,YGR094W,2618,518,3136,349,281,387,
1371,YOR192C,924,2225,3149,531,726,926,
1372,YLR010C,1369,1788,3157,2398,3271,3721,
1373,YNR030W,1802,1356,3158,969,1626,1346,
1374,YPL001W,407,2752,3159,1810,1898,3263,
1375,YEL011W,558,2603,3161,1544,2025,2004,
1376,YAL023C,2123,1040,3163,837,3148,871,
1377,YGL001C,1377,1790,3167,848,523,1333,
1378,YCL021W-A,1687,1481,3168,2818,5093,2855,
1379,YHR106W,1533,1637,3170,4000,3297,2119,
1380,YPL214C,2291,879,3170,1521,1270,1741,
1381,YCR034W,1800,1375,3175,655,532,1230,
1382,YER137C,940,2236,3176,5160,4208,3834,
1383,YHL026C,1953,1235,3188,3481,5587,1884,
1384,YAL061W,886,2302,3188,5220,5725,1796,
1385,YMR222C,1884,1308,3192,6073,5865,4473,
1386,YMR039C,2312,880,3192,1398,1754,714,
1387,YHR113W,1186,2016,3202,2133,3117,1450,
1388,YLL009C,1551,1654,3205,904,2973,436,
1389,YNL259C,2706,499,3205,994,538,1325,
1390,YPR166C,1679,1528,3207,1874,1110,1867,
1391,YOR176W,2438,770,3208,2443,2940,1276,
1392,YBR170C,895,2317,3212,3789,3853,4413,
1393,YER080W,1795,1421,3216,990,963,936,
1394,YKL210W,1922,1300,3222,1038,1702,941,
1395,YMR262W,889,2337,3226,6007,6132,6025,
1396,YDR469W,1677,1552,3229,4663,3101,4646,
1397,YHR043C,2683,547,3230,2994,1429,1969,
1398,YKL204W,1201,2029,3230,2791,1463,3071,
1399,YLR231C,2561,670,3231,3626,3083,2926,
1400,YFR006W,2018,1214,3232,873,873,1122,
1401,YJL115W,1999,1236,3235,5334,4920,1164,
1402,YPL049C,1170,2065,3235,6302,6205,5460,
1403,YIL016W,2330,905,3235,3978,5469,1351,
1404,YPR072W,826,2410,3236,1734,1212,2063,
1405,YGL041W-A,2036,1201,3237,2075,3204,1352,
1406,YHR057C,1396,1843,3239,5365,6023,1524,
1407,YKR049C,2582,661,3243,6493,6589,4588,
1408,YJL034W,2604,644,3248,291,202,267,
1409,YNL315C,2046,1202,3248,3566,2103,1692,
1410,YBR052C,1917,1331,3248,3940,4300,1541,
1411,YFR052W,1294,1956,3250,1480,4195,1849,
1412,YEL055C,1703,1547,3250,2198,1810,2345,
1413,YJR149W,1367,1884,3251,2790,1758,2872,
1414,YMR049C,830,2425,3255,745,552,816,
1415,YKL159C,1745,1514,3259,2648,2963,2253,
1416,YNR034W,1391,1868,3259,5146,5068,2905,
1417,YPR050C,901,2361,3262,3527,4998,2647,
1418,YGL159W,1359,1905,3264,1273,1120,1977,
1419,YBR056W,2513,757,3270,798,512,1275,
1420,YOL096C,906,2370,3276,3799,4437,2716,
1421,YDR365C,2117,1163,3280,781,880,645,
1422,YJR131W,518,2766,3284,3275,3569,2866,
1423,YIL170W,1602,1687,3289,2480,4509,1905,
1424,YPL122C,1204,2087,3291,1313,586,1686,
1425,YOR171C,868,2427,3295,2518,1378,2278,
1426,YJR085C,1868,1427,3295,3269,4228,3187,
1427,YBR104W,1788,1509,3297,5072,3317,3883,
1428,YNL121C,709,2589,3298,534,298,430,
1429,YLL011W,1826,1480,3306,767,661,973,
1430,YCR003W,1830,1482,3312,1257,991,1525,
1431,YLR286C,653,2660,3313,879,460,1836,
1432,YDL144C,1451,1862,3313,6193,6493,2213,
1433,YML091C,1053,2263,3316,1082,958,1916,
1434,YGR253C,2643,676,3319,3150,1788,2207,
1435,YNL040W,1682,1638,3320,2330,2497,1636,
1436,YDL213C,2202,1119,3321,2729,4479,646,
1437,YGL050W,1764,1559,3323,4687,4428,3502,
1438,YKL071W,2517,809,3326,3306,4524,3526,
1439,YML130C,1662,1664,3326,809,893,1335,
1440,YER042W,2471,863,3334,1094,329,2182,
1441,YJL031C,1065,2275,3340,1278,1430,1652,
1442,YIL063C,2309,1033,3342,2774,2782,1003,
1443,YBR166C,1942,1400,3342,2414,1101,2977,
1444,YOR262W,1010,2334,3344,3174,1867,2048,
1445,YNL307C,2951,397,3348,3305,3501,2226,
1446,YER019W,1471,1882,3353,5722,6380,2900,
1447,YDR183W,1573,1785,3358,3439,2313,3172,
1448,YDR168W,2183,1179,3362,1060,721,877,
1449,YJL197W,1427,1936,3363,2477,1875,2893,
1450,YGL156W,2035,1333,3368,1474,1129,1568,
1451,YLL022C,1440,1934,3374,5593,5753,1832,
1452,YER071C,2447,929,3376,2332,2441,3916,
1453,YDR193W,1092,2288,3380,6271,4852,5450,
1454,YDL172C,1993,1388,3381,3865,3900,2655,
1455,YML092C,771,2614,3385,4105,2395,2813,
1456,YGR169C-A,1749,1640,3389,6171,1866,592,
1457,YOR099W,2327,1062,3389,681,1279,1181,
1458,YHR069C,1388,2005,3393,3741,4659,3653,
1459,YKR041W,656,2739,3395,5319,6382,3235,
1460,YML067C,1429,1966,3395,1482,1282,1422,
1461,YBL094C,1365,2031,3396,3802,4234,6178,
1462,YHR038W,1578,1822,3400,2490,1503,2482,
1463,YBL015W,689,2712,3401,1374,4261,915,
1464,YNR019W,1841,1561,3402,1135,3292,1159,
1465,YOL065C,1132,2274,3406,4948,3752,4581,
1466,YKL077W,2176,1230,3406,802,793,1195,
1467,YGL043W,1955,1451,3406,1368,1779,1420,
1468,YPL085W,1482,1925,3407,3457,2766,3034,
1469,YPL036W,2503,906,3409,530,543,452,
1470,YMR221C,1628,1782,3410,2201,2368,4165,
1471,YIL061C,1585,1826,3411,3499,5524,1742,
1472,YDR541C,1016,2397,3413,1476,1041,1732,
1473,YJR132W,1744,1675,3419,2539,2204,2178,
1474,YNL108C,879,2541,3420,1927,1763,1950,
1475,YHL039W,1357,2064,3421,2333,1415,2011,
1476,YOR067C,912,2509,3421,2386,2241,4003,
1477,YOR052C,429,2993,3422,1713,3878,2025,
1478,YLR351C,2865,557,3422,5326,5431,2632,
1479,YJL087C,1084,2340,3424,1963,1168,1826,
1480,YFR014C,1502,1924,3426,3212,2734,1653,
1481,YNL154C,1043,2384,3427,1428,866,1681,
1482,YLR125W,1363,2067,3430,2242,1194,1535,
1483,YKL053C-A,1861,1572,3433,5532,4740,2779,
1484,YJR117W,1154,2282,3436,600,2220,954,
1485,YGR279C,2345,1093,3438,239,361,258,
1486,YOR250C,1054,2388,3442,5097,4005,5173,
1487,YIL034C,2587,856,3443,1945,4064,1503,
1488,YFR020W,1456,1990,3446,1225,1423,2771,
1489,YGR208W,2078,1371,3449,1148,3290,1236,
1490,YDR190C,2562,889,3451,1430,1069,1001,
1491,YGR076C,1334,2117,3451,1887,2376,2624,
1492,YOR106W,1193,2259,3452,4672,5371,3603,
1493,YDL163W,1601,1852,3453,5434,5381,3744,
1494,YLR031W,1153,2312,3465,4087,2585,3323,
1495,YMR010W,1254,2212,3466,2408,1390,3519,
1496,YER004W,2808,659,3467,5931,6002,1304,
1497,YDR036C,2537,931,3468,1101,1057,1190,
1498,YPR060C,2365,1104,3469,894,765,792,
1499,YIL076W,2523,950,3473,1048,1472,1059,
1500,YDR489W,504,2969,3473,1816,3616,2841,
1501,YLR059C,2637,839,3476,5189,6308,2368,
1502,YJR109C,2960,517,3477,713,444,785,
1503,YPR154W,2703,775,3478,1665,1260,2417,
1504,YNL173C,2129,1350,3479,5184,4968,1498,
1505,YGL122C,421,3059,3480,2752,2092,2383,
1506,YGR126W,1228,2253,3481,1364,1834,1468,
1507,YDR161W,2392,1090,3482,4431,2961,2493,
1508,YOR352W,1688,1795,3483,1688,2266,2842,
1509,YOR374W,2173,1310,3483,765,2281,501,
1510,YDR322C-A,2453,1031,3484,4544,2466,1914,
1511,YKR025W,1331,2156,3487,4611,4306,1056,
1512,YJR125C,1785,1705,3490,2031,1778,1386,
1513,YEL070W,1191,2300,3491,723,2941,678,
1514,YKR013W,963,2529,3492,909,1432,956,
1515,YJL050W,2362,1132,3494,1109,1029,868,
1516,YGR235C,1399,2096,3495,2878,3170,1595,
1517,YJR052W,1226,2270,3496,3993,4190,4018,
1518,YDL223C,1959,1537,3496,1429,1492,1774,
1519,YDR092W,1418,2083,3501,4096,4288,2354,
1520,YIL083C,2200,1301,3501,2083,2607,2265,
1521,YGL077C,1163,2338,3501,862,882,1632,
1522,YDR156W,1918,1586,3504,5491,6373,2139,
1523,YJL060W,2856,650,3506,1089,1231,1074,
1524,YBL098W,2686,820,3506,1702,1896,1641,
1525,YIR013C,1808,1701,3509,5697,5129,3395,
1526,YOL140W,2592,918,3510,1008,1065,1046,
1527,YMR278W,1114,2399,3513,1681,1359,1982,
1528,YER100W,1618,1895,3513,2178,2138,1978,
1529,YJR060W,1752,1763,3515,5316,5611,1622,
1530,YFL007W,2025,1492,3517,2577,3050,2614,
1531,YBR193C,1668,1854,3522,3771,4191,3202,
1532,YFL004W,2443,1079,3522,1150,730,1013,
1533,YDR257C,1336,2190,3526,1329,1340,2242,
1534,YBR026C,3152,376,3528,1769,1900,1984,
1535,YCR030C,1175,2353,3528,2426,2966,2138,
1536,YAR027W,1901,1631,3532,3747,3079,4492,
1537,YIL165C,1425,2107,3532,3932,4311,1228,
1538,YCR035C,1839,1694,3533,2239,1756,1740,
1539,YLR136C,2093,1440,3533,4122,3788,1932,
1540,YDR115W,1360,2175,3535,4695,4382,2294,
1541,YJR034W,2784,753,3537,5732,6008,5834,
1542,YBL007C,2464,1075,3539,1389,1241,1028,
1543,YOL030W,1047,2493,3540,584,1238,932,
1544,YKR009C,1532,2008,3540,3447,2541,1698,
1545,YOR391C,2368,1176,3544,3742,4603,2223,
1546,YBR296C,1796,1748,3544,601,389,620,
1547,YMR272C,1966,1583,3549,752,2000,1187,
1548,YEL053C,1431,2119,3550,1931,1436,2169,
1549,YBR192W,806,2746,3552,3972,1284,4032,
1550,YMR197C,1957,1596,3553,5181,4232,3974,
1551,YDL219W,2238,1315,3553,931,801,1291,
1552,YOR021C,2165,1390,3555,1351,1610,893,
1553,YGL089C,751,2804,3555,672,2030,508,
1554,YDR211W,1697,1858,3555,855,737,1063,
1555,YDL040C,1048,2508,3556,1209,1548,1149,
1556,YLR342W,2085,1472,3557,517,326,742,
1557,YML017W,2630,930,3560,3800,3683,2992,
1558,YJL114W,1967,1603,3570,1406,914,1260,
1559,YLR195C,2468,1103,3571,1375,1319,1115,
1560,YBL068W,2315,1257,3572,1002,629,1623,
1561,YBR056C-B,1650,1923,3573,3493,1072,3975,
1562,YJR002W,1070,2504,3574,2176,2032,1487,
1563,YKR093W,1168,2407,3575,610,1133,723,
1564,YMR276W,2252,1326,3578,4727,5663,1397,
1565,YBL069W,1681,1898,3579,2070,3276,1895,
1566,YGL181W,1069,2510,3579,5607,4101,3681,
1567,YGL094C,904,2681,3585,2503,2537,3988,
1568,YJL140W,2143,1442,3585,4691,3566,2202,
1569,YKL033W-A,3146,443,3589,2163,954,1548,
1570,YGL091C,1487,2104,3591,3630,3378,4179,
1571,YDL128W,2680,912,3592,2563,3318,2355,
1572,YLR206W,2430,1164,3594,2307,2733,1084,
1573,YOR246C,1276,2320,3596,5746,6063,3912,
1574,YNL250W,1287,2310,3597,1546,1286,1281,
1575,YAL054C,2905,694,3599,905,2651,621,
1576,YLR291C,1501,2099,3600,1606,1567,2424,
1577,YOR138C,798,2802,3600,6145,5946,4504,
1578,YBL038W,2072,1533,3605,2126,2698,2173,
1579,YGR174C,1886,1728,3614,5971,5397,2220,
1580,YKL148C,1666,1949,3615,833,1840,859,
1581,YLR069C,2606,1010,3616,1168,828,1108,
1582,YPL121C,2100,1518,3618,2718,2962,1456,
1583,YPL190C,1548,2071,3619,980,875,1097,
1584,YOR344C,716,2908,3624,1204,2311,1421,
1585,YDR396W,1473,2155,3628,1044,4257,2157,
1586,YMR002W,1885,1744,3629,2826,3612,1626,
1587,YDR299W,1705,1926,3631,1194,1108,771,
1588,YJR065C,1655,1982,3637,1319,1551,1317,
1589,YOR118W,1927,1711,3638,3528,1368,2282,
1590,YMR125W,1020,2619,3639,853,489,1408,
1591,YML004C,2548,1094,3642,1229,2929,1394,
1592,YOL046C,1323,2321,3644,5037,5170,4745,
1593,YGL235W,864,2781,3645,5442,5943,3826,
1594,YDR311W,1116,2531,3647,1236,1401,1048,
1595,YER122C,1620,2034,3654,1803,1467,1690,
1596,YBR151W,2229,1430,3659,3738,3228,3647,
1597,YPL178W,1615,2045,3660,1553,1512,2095,
1598,YNL085W,1851,1809,3660,880,540,1240,
1599,YGL250W,2262,1398,3660,3655,5032,2298,
1600,YPR017C,1534,2128,3662,1624,3562,5446,
1601,YOR065W,2039,1625,3664,523,475,638,
1602,YOL077W-A,2723,942,3665,1448,1489,857,
1603,YER141W,2167,1500,3667,1192,1209,1577,
1604,YJR118C,2398,1271,3669,965,510,1817,
1605,YHL003C,1446,2223,3669,1411,939,3128,
1606,YOL165C,993,2684,3677,4560,4694,1298,
1607,YFL048C,2170,1508,3678,1470,1283,1194,
1608,YKL008C,1445,2234,3679,814,1104,1889,
1609,YKR018C,2674,1005,3679,2305,1531,1439,
1610,YDL217C,1522,2158,3680,5312,1830,4908,
1611,YIL084C,1172,2512,3684,2196,2844,1660,
1612,YDR441C,2476,1210,3686,4963,4135,1780,
1613,YOR111W,1658,2028,3686,1977,2431,2596,
1614,YBR241C,2520,1170,3690,6259,6463,3431,
1615,YMR043W,1308,2386,3694,5844,5438,3297,
1616,YOR039W,1285,2411,3696,2857,2017,4330,
1617,YER067W,1322,2387,3709,1063,941,1235,
1618,YPR137W,1838,1874,3712,2902,2023,2016,
1619,YFR004W,2855,861,3716,1162,1529,831,
1620,YAR028W,2013,1704,3717,4237,4957,4520,
1621,YMR095C,2267,1450,3717,2913,2523,3324,
1622,YKL031W,907,2816,3723,5820,6157,4201,
1623,YKL082C,2297,1431,3728,2111,2097,708,
1624,YPL275W,2511,1217,3728,2359,3329,1265,
1625,YLR312W-A,1324,2406,3730,5341,4329,4630,
1626,YPR088C,2682,1053,3735,1506,1351,944,
1627,YOL088C,1828,1909,3737,1798,3215,2848,
1628,YBR287W,1187,2550,3737,1425,1843,2034,
1629,YPL263C,2094,1645,3739,1332,1797,1114,
1630,YKL013C,2694,1045,3739,4139,4147,1972,
1631,YNL130C,1793,1951,3744,1261,973,2235,
1632,YPL127C,2518,1229,3747,4539,6005,997,
1633,YDR297W,1483,2265,3748,988,3529,1082,
1634,YNL153C,2384,1365,3749,5886,6338,1449,
1635,YPR063C,2341,1409,3750,1992,4117,1332,
1636,YIL059C,1082,2669,3751,6120,5889,5780,
1637,YDR139C,2218,1535,3753,5702,4916,3250,
1638,YOL021C,2385,1370,3755,1799,2481,1554,
1639,YER125W,2109,1647,3756,1310,1315,1596,
1640,YNL007C,2829,928,3757,1928,1137,1347,
1641,YKR095W,1775,1984,3759,2235,1869,1466,
1642,YOR238W,1496,2266,3762,1916,1727,2028,
1643,YLR250W,1667,2102,3769,1103,1162,848,
1644,YOR100C,2442,1328,3770,4342,2796,2358,
1645,YGL212W,1167,2605,3772,6074,6264,5614,
1646,YPR190C,1237,2538,3775,3720,2632,1808,
1647,YCL046W,2020,1755,3775,5302,5487,4850,
1648,YJL012C,2556,1221,3777,710,842,648,
1649,YNL161W,1098,2686,3784,2516,1374,2397,
1650,YMR220W,2280,1504,3784,2934,1418,2517,
1651,YDR127W,3186,599,3785,883,688,999,
1652,YBR278W,1985,1811,3796,5578,5559,4386,
1653,YLR330W,2461,1336,3797,3058,2118,1971,
1654,YPL212C,457,3341,3798,1356,2084,1145,
1655,YML021C,1724,2082,3806,5367,4062,3678,
1656,YJR073C,2329,1478,3807,3893,6197,1827,
1657,YMR193W,1335,2477,3812,1464,1061,1061,
1658,YCR090C,2011,1803,3814,1836,1094,2599,
1659,YML032C,1810,2006,3816,4947,4865,3792,
1660,YNL256W,1944,1872,3816,2575,1833,1901,
1661,YMR056C,1557,2262,3819,6148,6213,2964,
1662,YAL018C,1690,2129,3819,2267,2403,2393,
1663,YIL035C,1691,2134,3825,1023,962,1830,
1664,YJL002C,2344,1485,3829,1625,1546,1680,
1665,YNL288W,1212,2620,3832,4719,5172,3726,
1666,YLR370C,2231,1608,3839,2747,4759,2347,
1667,YBR115C,2310,1530,3840,857,746,1010,
1668,YKR088C,2624,1216,3840,1820,2657,2024,
1669,YDL012C,1844,1997,3841,5249,4400,5118,
1670,YHR162W,2610,1234,3844,4606,5789,2404,
1671,YGR262C,1448,2396,3844,4286,5067,3819,
1672,YML011C,1879,1975,3854,4838,5169,5097,
1673,YPR046W,1916,1938,3854,4004,4888,2270,
1674,YKR074W,2743,1111,3854,1353,3135,1747,
1675,YNL105W,987,2869,3856,2452,1214,4486,
1676,YKR048C,2978,878,3856,5996,6489,939,
1677,YIL030C,1311,2548,3859,1500,1942,1915,
1678,YEL030W,1781,2079,3860,1308,1796,988,
1679,YNL075W,1283,2581,3864,2164,1264,1810,
1680,YFR051C,2786,1081,3867,2461,5328,1007,
1681,YPR110C,1776,2093,3869,789,577,705,
1682,YGR145W,2756,1115,3871,840,838,722,
1683,YJL044C,2209,1665,3874,1917,3591,2283,
1684,YHR214W,1972,1903,3875,536,2985,697,
1685,YDR019C,2463,1414,3877,3257,3127,2570,
1686,YBL113C,1412,2466,3878,4278,5997,3758,
1687,YNL163C,2227,1652,3879,2983,1826,2390,
1688,YOR287C,1421,2458,3879,2406,3874,2204,
1689,YBR242W,2982,899,3881,3508,5152,2377,
1690,YBR173C,2103,1784,3887,2252,5344,2416,
1691,YLR284C,2598,1290,3888,4798,4341,2982,
1692,YML103C,439,3450,3889,1747,1405,2788,
1693,YMR184W,2549,1341,3890,3504,2787,2432,
1694,YGL241W,925,2967,3892,2653,1495,3467,
1695,YPL002C,2163,1732,3895,4665,4440,5158,
1696,YJR006W,1480,2416,3896,2276,3753,2104,
1697,YOR046C,3232,669,3901,983,465,718,
1698,YNL193W,1811,2092,3903,1720,2513,2049,
1699,YLR445W,1926,1979,3905,942,2048,1234,
1700,YFL017C,2615,1291,3906,4848,5742,1947,
1701,YPL019C,2403,1503,3906,1163,694,1528,
1702,YLR300W,1914,1993,3907,367,513,535,
1703,YJL171C,2062,1846,3908,734,856,1425,
1704,YLR274W,730,3179,3909,1300,936,1452,
1705,YKL138C,595,3314,3909,773,480,752,
1706,YDR267C,2527,1384,3911,3303,3441,3234,
1707,YKL107W,3213,701,3914,5006,5462,4616,
1708,YOR086C,2867,1048,3915,871,959,745,
1709,YDL108W,1279,2641,3920,4156,2584,2750,
1710,YPR128C,2599,1323,3922,3138,2442,2533,
1711,YMR305C,1433,2494,3927,761,911,688,
1712,YDR020C,1171,2756,3927,2552,4388,2041,
1713,YPL249C,1938,1991,3929,4519,3319,1991,
1714,YJL079C,2095,1834,3929,660,1572,523,
1715,YNL059C,1660,2273,3933,1427,1294,1658,
1716,YER010C,2806,1128,3934,5126,4810,4809,
1717,YOR196C,2502,1434,3936,4028,1853,2299,
1718,YDR377W,2022,1916,3938,808,316,1050,
1719,YPR125W,1904,2038,3942,2777,4052,1504,
1720,YNL280C,2696,1246,3942,2072,3288,1948,
1721,YHR075C,1738,2205,3943,3473,1945,3549,
1722,YGL226C-A,2324,1620,3944,688,904,819,
1723,YIL157C,2111,1833,3944,2435,5230,1280,
1724,YJR088C,2539,1406,3945,1478,1612,1749,
1725,YDR280W,2043,1906,3949,4244,3783,2749,
1726,YGR210C,3222,728,3950,5804,5798,3558,
1727,YOR277C,2913,1039,3952,4557,642,1715,
1728,YDR153C,1727,2226,3953,2469,4146,1627,
1729,YHR052W,2901,1054,3955,613,413,633,
1730,YLR306W,1656,2301,3957,3848,2827,4001,
1731,YNL308C,2614,1348,3962,1832,1902,659,
1732,YBL090W,1803,2162,3965,4310,4928,1593,
1733,YNL024C,1135,2830,3965,3165,2568,3047,
1734,YLL044W,2577,1389,3966,1410,5399,6501,
1735,YNR061C,1797,2173,3970,2524,2785,3869,
1736,YNL062C,1675,2297,3972,2489,2760,2192,
1737,YGR178C,2360,1612,3972,1778,1178,1215,
1738,YMR244C-A,2084,1890,3974,5207,6175,1575,
1739,YDR121W,2353,1622,3975,5616,4583,2179,
1740,YAR066W,2126,1851,3977,577,3199,730,
1741,YAL029C,1814,2164,3978,2269,2536,2161,
1742,YML057W,1768,2211,3979,3765,4790,2460,
1743,YBL059C-A,1415,2566,3981,764,2525,767,
1744,YER014W,1338,2643,3981,4615,4745,2587,
1745,YNL331C,2305,1680,3985,3938,3255,2529,
1746,YOL022C,3067,919,3986,1940,1602,1841,
1747,YDL146W,815,3174,3989,1844,2285,2467,
1748,YJL158C,2543,1449,3992,209,111,265,
1749,YNL049C,1762,2232,3994,2108,1477,2177,
1750,YGL246C,2211,1783,3994,3070,1950,3001,
1751,YDL140C,2196,1801,3997,1022,674,1364,
1752,YIL149C,1219,2778,3997,2804,1790,1584,
1753,YJR017C,3443,555,3998,6245,6547,2528,
1754,YNL231C,1847,2152,3999,1043,732,1670,
1755,YKR007W,1413,2586,3999,6216,6003,4178,
1756,YMR011W,1809,2191,4000,362,334,467,
1757,YPR184W,2141,1861,4002,2959,3732,2231,
1758,YNL312W,3333,677,4010,1629,2263,1365,
1759,YLR026C,2284,1727,4011,3331,4709,2026,
1760,YKL189W,628,3385,4013,1863,1985,2845,
1761,YBR022W,1626,2389,4015,4453,3775,5106,
1762,YMR156C,1606,2412,4018,2491,3357,3464,
1763,YDR068W,2373,1646,4019,1527,2020,1130,
1764,YNR070W,882,3142,4024,1525,1025,1990,
1765,YLL052C,1011,3014,4025,1139,4365,1937,
1766,YOR057W,1988,2042,4030,1929,830,2109,
1767,YCL038C,1594,2436,4030,4049,4106,5298,
1768,YOR116C,2454,1578,4032,935,689,1378,
1769,YDL078C,3559,475,4034,4368,5492,1946,
1770,YKR062W,2195,1840,4035,1246,1493,934,
1771,YHR138C,3057,979,4036,1646,3535,1440,
1772,YLR034C,2181,1855,4036,967,927,1400,
1773,YMR312W,1526,2511,4037,2434,5045,3520,
1774,YER175C,1553,2486,4039,1956,2440,2081,
1775,YGL254W,3157,882,4039,3639,4458,5578,
1776,YDR300C,3020,1025,4045,1144,676,960,
1777,YDR051C,2304,1741,4045,1851,1687,2277,
1778,YGR106C,2923,1123,4046,644,514,1049,
1779,YKL126W,2633,1415,4048,1574,961,1806,
1780,YOR145C,2042,2009,4051,2862,4176,1341,
1781,YDR088C,1664,2390,4054,2322,1604,2286,
1782,YHR111W,2432,1624,4056,4780,4468,4608,
1783,YER002W,2911,1145,4056,1983,892,665,
1784,YOL061W,2007,2051,4058,1593,2880,1505,
1785,YBR172C,1157,2902,4059,2373,2049,2013,
1786,YPL088W,2777,1282,4059,3357,4540,2341,
1787,YHR176W,1379,2682,4061,3834,5237,2561,
1788,YDR261W-A,1121,2941,4062,1095,863,2331,
1789,YOR195W,1989,2074,4063,1675,1003,1268,
1790,YPR140W,1478,2598,4076,2880,2026,2480,
1791,YDR248C,1225,2854,4079,2326,1290,1071,
1792,YDR210W-A,1199,2881,4080,1031,747,2219,
1793,YBR078W,2486,1595,4081,165,198,237,
1794,YHR060W,2480,1605,4085,2825,2646,1989,
1795,YDR292C,2113,1974,4087,1943,1261,2101,
1796,YBL071W-A,2764,1325,4089,3644,3549,2266,
1797,YOL010W,1869,2221,4090,2088,1883,1597,
1798,YEL069C,1217,2875,4092,1403,2679,2553,
1799,YOR383C,1124,2978,4102,247,379,310,
1800,YDR308C,2553,1549,4102,2802,2771,2425,
1801,YGR012W,2586,1520,4106,3325,4406,1847,
1802,Q0080,2943,1165,4108,364,0,817,
1803,YDL243C,2572,1539,4111,2065,1976,1751,
1804,YIL110W,2429,1683,4112,1919,2699,2817,
1805,YJR137C,1887,2228,4115,643,445,728,
1806,YDR540C,1583,2537,4120,2710,711,1321,
1807,YFR037C,2235,1887,4122,5987,6256,2105,
1808,YBR179C,654,3468,4122,2744,2839,2516,
1809,YEL038W,3927,196,4123,5889,6104,2891,
1810,YAL064C-A,776,3348,4124,1129,902,1172,
1811,YLR211C,2367,1757,4124,2343,1377,2083,
1812,YDR040C,1639,2488,4127,1199,1821,1261,
1813,YIL011W,581,3547,4128,270,73,243,
1814,YCR002C,3151,977,4128,1709,1444,1665,
1815,YGR009C,1881,2249,4130,4474,2673,2572,
1816,YLR065C,2819,1311,4130,4588,3981,1775,
1817,YDL052C,2159,1972,4131,1091,2777,1057,
1818,YLR447C,2371,1764,4135,622,616,889,
1819,YGL100W,3005,1130,4135,3076,2317,3991,
1820,YMR009W,2833,1309,4142,2783,4264,1699,
1821,YER014C-A,1077,3068,4145,1439,5252,2641,
1822,YNR065C,475,3673,4148,2318,1349,1957,
1823,YIL020C,3224,927,4151,1918,1716,2352,
1824,YNR038W,2306,1845,4151,1516,2549,1553,
1825,YIR027C,3252,901,4153,5179,5244,2625,
1826,YDR345C,3131,1023,4154,233,36,342,
1827,YCL049C,1521,2635,4156,3763,4814,2960,
1828,YKL186C,3056,1102,4158,4711,5578,4046,
1829,YML048W,3421,739,4160,1472,3169,955,
1830,YML110C,3023,1139,4162,1776,2978,1277,
1831,YPL246C,2636,1526,4162,5159,5402,4597,
1832,YPL173W,2397,1766,4163,2725,1627,1953,
1833,YDL177C,2720,1444,4164,2972,3201,2593,
1834,YBL051C,2290,1875,4165,1145,894,1538,
1835,YBR003W,1302,2865,4167,3885,3879,3026,
1836,YJL213W,1624,2545,4169,4092,2270,2378,
1837,YHR001W,2916,1255,4171,3383,2401,1667,
1838,YKR024C,973,3201,4174,2274,2365,2292,
1839,YPL098C,2122,2057,4179,4702,5342,4701,
1840,YNR073C,1408,2772,4180,739,2869,704,
1841,YGL232W,2381,1800,4181,1923,1389,1760,
1842,YLR154C,1208,2973,4181,4923,6076,3676,
1843,YGR289C,1853,2331,4184,1714,1347,2407,
1844,YKR075W-A,2802,1383,4185,1721,2075,1789,
1845,YOL147C,3195,997,4192,4102,5224,2573,
1846,YDR374C,1005,3189,4194,1295,559,1343,
1847,YOL111C,1852,2346,4198,3378,5731,1615,
1848,YOR306C,1825,2374,4199,2118,3027,2620,
1849,YMR107W,3456,745,4201,5490,5467,3005,
1850,YMR196W,2086,2120,4206,1369,2085,1883,
1851,YOL082W,2343,1864,4207,1759,3644,1931,
1852,YHR169W,853,3355,4208,4164,4478,2910,
1853,YCL059C,1945,2264,4209,869,846,874,
1854,YNL119W,1145,3064,4209,1772,997,2218,
1855,YGL252C,1863,2347,4210,2899,1808,3551,
1856,YAL046C,3419,793,4212,6042,6324,2751,
1857,YER142C,2177,2036,4213,2958,1580,2961,
1858,YDR465C,2941,1274,4215,1693,2035,1607,
1859,YMR088C,1719,2497,4216,4559,3958,4925,
1860,YOR119C,1555,2662,4217,1492,829,1176,
1861,YHR024C,2470,1756,4226,3998,3916,2318,
1862,YEL017W,2087,2139,4226,5718,6202,4633,
1863,YCR057C,2259,1967,4226,2514,3804,2075,
1864,YGL224C,3044,1186,4230,3059,2189,2709,
1865,YGR114C,482,3750,4232,1457,6137,4231,
1866,YER078C,1552,2680,4232,2123,2265,1986,
1867,YDL222C,1862,2372,4234,6040,6158,3825,
1868,YBL004W,1006,3238,4244,2122,2002,3408,
1869,YJL049W,883,3361,4244,1435,1060,1614,
1870,YNL155W,3091,1153,4244,2074,2091,2418,
1871,YDR201W,3134,1116,4250,3347,2855,908,
1872,YOL149W,1730,2520,4250,2486,1668,4106,
1873,YDR492W,726,3526,4252,1156,4485,2188,
1874,YGL101W,3031,1225,4256,1042,949,1892,
1875,YNL142W,1708,2549,4257,874,720,1396,
1876,YOR036W,1969,2295,4264,5807,5144,4691,
1877,YNR072W,1004,3264,4268,1123,1876,2247,
1878,YFL002W-B,1430,2838,4268,1078,844,2216,
1879,YLR072W,1929,2344,4273,5499,5478,3185,
1880,YDR234W,3011,1265,4276,1768,3521,1387,
1881,YLR409C,1801,2476,4277,1420,1341,1846,
1882,YGR187C,2441,1836,4277,1216,588,1126,
1883,YDL050C,2220,2060,4280,3208,4750,2209,
1884,YNL237W,1125,3158,4283,4873,4934,3902,
1885,YEL015W,2626,1659,4285,2836,2546,1794,
1886,YEL065W,657,3632,4289,1183,1761,1560,
1887,YJR130C,1976,2315,4291,4003,3989,3275,
1888,YGR153W,1758,2534,4292,5399,5118,4957,
1889,YBR262C,2052,2241,4293,5742,5859,4707,
1890,YDR305C,2009,2287,4296,1489,1018,2693,
1891,YJL041W,1875,2424,4299,2207,1675,1755,
1892,YEL039C,2487,1813,4300,1366,707,1208,
1893,YPL051W,2709,1594,4303,2765,1362,3749,
1894,YER086W,1647,2657,4304,479,591,635,
1895,YPR112C,2544,1761,4305,1401,1308,845,
1896,YHR219W,1251,3056,4307,5682,6109,4534,
1897,YDL008W,1771,2536,4307,1535,3520,3377,
1898,YEL056W,1131,3178,4309,2240,2402,3607,
1899,YGR161W-A,1401,2915,4316,1080,843,2210,
1900,YDR383C,2428,1891,4319,5495,4451,3015,
1901,YOR343W-A,1317,3007,4324,995,699,2190,
1902,YDL210W,1455,2870,4325,796,447,1434,
1903,YOR321W,2144,2182,4326,2221,2898,2765,
1904,YNL251C,1148,3180,4328,2273,2618,2762,
1905,YBR086C,1934,2394,4328,1555,1179,1951,
1906,YCR027C,1948,2381,4329,5961,5542,5774,
1907,YOR260W,1635,2696,4331,1386,1941,2232,
1908,YDR237W,996,3340,4336,1903,1870,2802,
1909,YPL139C,3181,1157,4338,2795,1760,2600,
1910,YBL078C,2725,1614,4339,3234,3709,1021,
1911,YAL008W,3118,1222,4340,4161,4418,2262,
1912,YMR319C,1617,2726,4343,1057,984,1599,
1913,YLR390W-A,825,3519,4344,422,1481,533,
1914,YCL009C,3080,1264,4344,1563,5820,822,
1915,YOL122C,1142,3203,4345,1580,1034,2403,
1916,YNL232W,2565,1781,4346,5307,3659,3470,
1917,YBR227C,2139,2208,4347,2063,1079,1467,
1918,YNL261W,1198,3151,4349,1726,1655,2898,
1919,YGR207C,2787,1564,4351,1471,1088,897,
1920,YKL073W,1390,2962,4352,2761,2669,1886,
1921,YHL009W-A,1930,2422,4352,1055,544,1606,
1922,YCR020C-A,3809,545,4354,2186,3519,1726,
1923,YKL163W,891,3463,4354,333,215,375,
1924,YCR073W-A,2576,1778,4354,6081,6430,5017,
1925,YGR165W,1621,2734,4355,2745,2526,1910,
1926,Q0130,2534,1821,4355,806,27,1184,
1927,YDL195W,3132,1223,4355,1087,839,1283,
1928,YFR036W,1891,2465,4356,5670,6536,2348,
1929,YIL115C,796,3561,4357,3261,1590,2653,
1930,YEL053W-A,1757,2600,4357,6165,3587,4770,
1931,YPL224C,2469,1888,4357,4730,3970,3817,
1932,YIL024C,2154,2206,4360,4796,6030,2449,
1933,YPL067C,3114,1248,4362,6317,6581,5056,
1934,YDR508C,2243,2121,4364,1165,1354,1646,
1935,YOR108W,3575,789,4364,707,1082,717,
1936,YDR530C,2729,1635,4364,4476,5051,3682,
1937,YGR016W,1779,2585,4364,2374,3226,5538,
1938,YDR007W,1328,3037,4365,5240,3261,3411,
1939,YLR005W,1339,3028,4367,3549,3593,3904,
1940,YOR197W,3351,1018,4369,1583,1289,1666,
1941,YMR180C,965,3405,4370,3571,4593,3083,
1942,YGR130C,2840,1534,4374,1867,2363,996,
1943,YML010W,2612,1762,4374,1327,1232,911,
1944,YER118C,1452,2924,4376,1636,1638,3007,
1945,YBR061C,2400,1977,4377,3943,1757,3619,
1946,YDR059C,2355,2023,4378,1195,1404,1994,
1947,YDR196C,1965,2419,4384,4357,2902,3775,
1948,YBL029C-A,2657,1730,4387,3041,5275,6260,
1949,YDL202W,2559,1829,4388,5266,4706,3136,
1950,YIL143C,1090,3300,4390,1686,1557,1381,
1951,YBR036C,2186,2204,4390,3913,5540,3122,
1952,YER164W,1892,2499,4391,1937,2400,1513,
1953,YHR054C,908,3484,4392,1028,524,2029,
1954,YPR010C-A,2249,2147,4396,1880,500,1255,
1955,YMR108W,3217,1180,4397,639,741,617,
1956,YCL076W,1554,2847,4401,2595,4637,2983,
1957,YBR267W,2152,2250,4402,3627,5600,1278,
1958,YGR161W-C,2271,2135,4406,6366,6223,6124,
1959,YAL016W,2955,1454,4409,1718,912,1488,
1960,YOR311C,2697,1712,4409,2643,2139,3675,
1961,YPR096C,2382,2030,4412,3748,5251,3030,
1962,YPR075C,1848,2565,4413,5115,5472,3832,
1963,YBL091C-A,2754,1660,4414,5672,5787,5175,
1964,YOR340C,2396,2020,4416,1326,1456,1729,
1965,YEL002C,3013,1404,4417,1707,2988,1795,
1966,YGL188C-A,3212,1205,4417,1035,672,1533,
1967,YDL097C,2667,1750,4417,4160,4909,2240,
1968,YDR256C,1375,3043,4418,2356,3001,2194,
1969,YGL231C,893,3528,4421,1924,665,2775,
1970,YLR066W,2899,1524,4423,1383,1020,1776,
1971,YHR107C,3716,707,4423,1550,2156,981,
1972,YHR114W,2578,1853,4431,1995,2384,1581,
1973,YHR165W-A,1750,2685,4435,5695,4978,5104,
1974,YGR194C,2981,1455,4436,3541,3638,3361,
1975,YBR077C,2938,1498,4436,3036,4431,2548,
1976,YDL173W,2827,1610,4437,3479,5595,1287,
1977,YLR055C,2689,1749,4438,5932,6049,2870,
1978,YJR024C,3536,903,4439,5375,5457,2694,
1979,YOR370C,1873,2569,4442,1987,1938,2122,
1980,YBL058W,3244,1198,4442,4041,3615,1757,
1981,YDR170C,3473,970,4443,1102,1134,1429,
1982,YGL070C,3185,1260,4445,3250,3193,3035,
1983,YLL002W,841,3605,4446,5301,4756,4248,
1984,YGL130W,2730,1722,4452,3904,2455,3045,
1985,YPL250C,2824,1628,4452,5078,5962,2857,
1986,YDR335W,1494,2960,4454,1941,1446,2766,
1987,YLR201C,2380,2076,4456,1571,1577,1567,
1988,YLL040C,2029,2428,4457,1729,1676,1731,
1989,YDR352W,1992,2468,4460,5829,4967,5581,
1990,YCR083W,3312,1150,4462,3310,4425,1616,
1991,YDR390C,1301,3165,4466,2136,1968,1961,
1992,YPL009C,2049,2418,4467,1280,1625,1349,
1993,YOL091W,1249,3219,4468,1655,1131,2160,
1994,YOR168W,3847,621,4468,552,344,601,
1995,YFR025C,1712,2760,4472,4233,5760,3845,
1996,YHR207C,2300,2178,4478,3065,2320,3226,
1997,YCL033C,1706,2774,4480,5691,6154,4146,
1998,YER182W,2006,2475,4481,4218,3146,2263,
1999,YFR031C,805,3678,4483,3259,2196,2714,
2000,YPL192C,2510,1973,4483,3293,1517,4101,
2001,YML080W,2529,1955,4484,1782,1666,1544,
2002,YLR081W,2015,2470,4485,696,978,798,
2003,YHR200W,2419,2069,4488,6235,6016,3512,
2004,YLR309C,1786,2703,4489,2942,1520,1534,
2005,YPL152W,995,3494,4489,1853,2131,3636,
2006,YNL099C,1931,2559,4490,2591,3885,2745,
2007,YPL045W,702,3789,4491,3986,3219,3706,
2008,YGL104C,2668,1824,4492,4039,4164,3448,
2009,YMR321C,2404,2089,4493,1514,4684,2430,
2010,YDR523C,2333,2161,4494,3230,1855,2346,
2011,YLR386W,998,3497,4495,3815,3903,3281,
2012,YDR395W,2862,1634,4496,1141,1142,1393,
2013,YKL099C,2148,2350,4498,3376,4535,1701,
2014,YER101C,2494,2007,4501,2417,1618,2818,
2015,YER031C,3713,790,4503,2915,4225,2126,
2016,YML054C,2074,2430,4504,1226,1166,1432,
2017,YOR056C,2661,1844,4505,3853,4120,2015,
2018,YCR017C,2458,2052,4510,1901,1542,2436,
2019,YGL014C-A,3110,1401,4511,2288,5748,4961,
2020,YML072C,2993,1519,4512,939,913,1058,
2021,YOR092W,688,3825,4513,1598,2391,1900,
2022,YLR002C,1271,3245,4516,2017,2221,1781,
2023,YKL028W,3565,951,4516,1081,691,919,
2024,YIL044C,2928,1590,4518,2776,2428,3622,
2025,YJL088W,2505,2013,4518,797,549,1671,
2026,YPL023C,2206,2314,4520,3613,3915,2795,
2027,YJR078W,3059,1466,4525,5597,5948,2946,
2028,YJL082W,2545,1983,4528,1601,1386,2071,
2029,YPL251W,1310,3218,4528,6107,6228,5752,
2030,YIR032C,3728,806,4534,6316,6090,4830,
2031,YGL029W,3462,1074,4536,1158,1165,353,
2032,YMR294W,3015,1522,4537,3781,4198,1988,
2033,YGL125W,2498,2043,4541,1399,5505,1043,
2034,YGL049C,2258,2283,4541,1446,1218,1205,
2035,YBR285W,3230,1313,4543,1677,3407,1995,
2036,YPR144C,1736,2808,4544,2632,2623,2411,
2037,YDR238C,2765,1779,4544,916,1201,1079,
2038,YBR030W,1686,2861,4547,3095,3962,3482,
2039,YBR071W,1325,3224,4549,4676,5635,2549,
2040,YDL043C,1355,3195,4550,1907,1974,3709,
2041,YDL121C,2932,1621,4553,2675,2571,1853,
2042,YGR219W,2030,2524,4554,491,1506,2244,
2043,YLL055W,2299,2255,4554,2151,1460,2490,
2044,YOR245C,951,3604,4555,3920,2006,4075,
2045,YHL013C,2707,1849,4556,2955,1305,1523,
2046,YJR134C,2120,2438,4558,2614,964,1818,
2047,YHR122W,2279,2279,4558,5042,5037,4340,
2048,YJR082C,3835,723,4558,3929,4488,3715,
2049,YGR276C,3112,1447,4559,2606,2470,2123,
2050,YOL155C,1166,3395,4561,666,1478,807,
2051,YGR104C,1218,3344,4562,3341,3758,4323,
2052,YOL141W,1592,2976,4568,3300,3858,3913,
2053,YLL001W,1791,2777,4568,1730,1912,1851,
2054,YJL148W,2848,1723,4571,1232,1649,1039,
2055,YFR001W,2974,1598,4572,1673,1654,1090,
2056,YJR057W,3652,921,4573,2949,2847,1979,
2057,YLR275W,2110,2464,4574,3142,1391,2811,
2058,YHR005C,3952,622,4574,2682,3258,2311,
2059,YDR380W,3550,1026,4576,1826,2458,2505,
2060,YPL210C,1306,3273,4579,1758,1561,1527,
2061,YDR009W,1739,2840,4579,3921,3650,3655,
2062,YNL316C,2684,1896,4580,2570,3402,3505,
2063,YHL047C,2145,2440,4585,3537,3200,3367,
2064,YKL032C,2293,2296,4589,3048,4433,1958,
2065,YFR045W,2023,2571,4594,3979,3845,1952,
2066,YPR097W,1735,2860,4595,1602,999,1935,
2067,YOR338W,1630,2970,4600,4792,3576,3421,
2068,YPL239W,2877,1724,4601,4186,4966,1399,
2069,YDR486C,3806,798,4604,4475,4330,1572,
2070,YFR002W,1928,2676,4604,1743,1903,1888,
2071,YDR524C-B,625,3979,4604,136,1787,188,
2072,YJR067C,2303,2306,4609,3550,4611,4751,
2073,YML121W,1684,2925,4609,4565,5196,4121,
2074,YJR032W,2473,2137,4610,1085,1153,1354,
2075,YPL043W,2914,1699,4613,1266,1005,675,
2076,YOR194C,1857,2759,4616,4856,4736,2308,
2077,YBR126C,3767,852,4619,2692,5382,1477,
2078,YPR143W,2277,2343,4620,1235,886,560,
2079,YDR169C-A,3277,1343,4620,3192,3639,4440,
2080,YLR285W,3509,1112,4621,1495,683,1723,
2081,YDR476C,3079,1544,4623,6556,6655,5625,
2082,YOR087W,2357,2268,4625,2568,2911,2672,
2083,YLR045C,3731,896,4627,5036,4464,2636,
2084,YNL181W,3572,1057,4629,1554,1710,1430,
2085,YFL060C,2079,2554,4633,3730,3897,3799,
2086,YER189W,2771,1863,4634,4071,4881,1289,
2087,YBR247C,2698,1937,4635,1224,1426,1244,
2088,YNL090W,2758,1877,4635,4800,2463,3609,
2089,YBL105C,1464,3173,4637,1766,1440,1992,
2090,YDL218W,3574,1073,4647,3676,4589,3641,
2091,YMR289W,2214,2434,4648,3994,3905,4454,
2092,YKL063C,3253,1395,4648,1785,857,1366,
2093,YHR218W,905,3747,4652,6393,6403,6016,
2094,YDL116W,1195,3458,4653,2090,1981,2452,
2095,YGL079W,2437,2217,4654,2919,3731,2646,
2096,YML018C,1950,2704,4654,5211,5739,4241,
2097,YJL024C,3169,1487,4656,3681,3043,2707,
2098,YHR170W,3298,1359,4657,753,671,842,
2099,YFL016C,3363,1295,4658,4120,5460,1433,
2100,YJL035C,1836,2823,4659,4830,5088,3302,
2101,YOR078W,2721,1939,4660,5009,3517,2617,
2102,YOR130C,1129,3533,4662,6054,4941,5984,
2103,YKL213C,2418,2245,4663,3981,3392,3773,
2104,YEL058W,3328,1335,4663,4566,5522,2259,
2105,YDR247W,1118,3554,4672,2007,4181,2129,
2106,YHL043W,2298,2376,4674,1189,2257,1334,
2107,YNL003C,1454,3221,4675,5187,4370,5300,
2108,YHR121W,3632,1043,4675,2360,4351,1885,
2109,YIL120W,1239,3436,4675,5202,2604,4186,
2110,YLL057C,1906,2771,4677,2773,2645,2316,
2111,YDR480W,2057,2623,4680,3576,2505,2507,
2112,YHR013C,4030,651,4681,1872,3630,1024,
2113,YHL018W,2336,2348,4684,5047,6342,3958,
2114,YDR536W,1774,2912,4686,1244,1154,1270,
2115,YKL025C,983,3704,4687,1481,2104,3025,
2116,YDR498C,1309,3378,4687,5001,5697,4060,
2117,YBL100W-A,1889,2799,4688,1034,725,2221,
2118,YHR197W,1210,3482,4692,1599,1117,1539,
2119,YBL083C,1582,3110,4692,5308,6348,5712,
2120,YOR236W,2759,1933,4692,5738,5443,4128,
2121,YKL098W,1575,3117,4692,6215,5812,4861,
2122,YHR133C,3802,892,4694,1670,1842,2181,
2123,YBR094W,3032,1663,4695,1173,1176,1319,
2124,YDL045W-A,3202,1494,4696,3758,2543,5049,
2125,YML030W,3608,1088,4696,5285,5561,1274,
2126,YBR180W,3108,1591,4699,3642,2964,4344,
2127,YIR036W-A,1805,2894,4699,5387,6178,5843,
2128,YOL103W,2131,2568,4699,1509,979,2053,
2129,YBL011W,2389,2311,4700,2992,5154,1644,
2130,YOR123C,2508,2193,4701,2970,3437,1372,
2131,YAL016C-B,2842,1860,4702,410,58,832,
2132,YDR381C-A,2568,2136,4704,3696,3115,3393,
2133,YNL093W,2597,2109,4706,4038,2992,3244,
2134,YDL148C,3785,922,4707,907,791,799,
2135,YOR109W,2226,2482,4708,2576,1508,3000,
2136,YLR163C,2790,1920,4710,3062,1043,1669,
2137,YDR328C,4069,642,4711,3454,6185,1239,
2138,YGR260W,2179,2532,4711,1322,3761,2054,
2139,YLR004C,3429,1283,4712,787,1329,1380,
2140,YLR410W-A,1983,2733,4716,926,684,2078,
2141,YHR066W,2002,2714,4716,1335,1132,1269,
2142,YDL234C,2285,2435,4720,2105,2957,2705,
2143,YPR100W,2452,2269,4721,4894,4215,2633,
2144,YMR297W,2233,2490,4723,835,4892,777,
2145,YKL161C,1670,3054,4724,3370,2631,4337,
2146,YLR108C,1996,2728,4724,3233,3745,2542,
2147,YMR048W,1673,3052,4725,3379,2954,2837,
2148,YER079W,2625,2100,4725,1817,4055,2743,
2149,YJR144W,3362,1366,4728,2603,3681,1730,
2150,YNR017W,2837,1892,4729,5916,5988,4494,
2151,YER145C,1772,2957,4729,2205,5425,1754,
2152,YOR055W,2201,2528,4729,5421,5077,4996,
2153,YOL131W,2617,2114,4731,6239,5896,5531,
2154,YIL137C,3526,1209,4735,1846,3000,1592,
2155,YBR253W,3174,1562,4736,6370,5990,4516,
2156,YEL003W,2501,2237,4738,976,397,1161,
2157,YKL046C,2296,2444,4740,823,446,1320,
2158,YER148W,3480,1261,4741,2506,1913,1625,
2159,YHR139C-A,2040,2702,4742,4721,5264,4679,
2160,YER046W,1759,2985,4744,4703,5066,3669,
2161,YJL039C,2024,2720,4744,2292,1969,2630,
2162,YDR517W,3097,1650,4747,5699,6065,3266,
2163,YDL053C,1909,2839,4748,4297,1439,4563,
2164,YPL148C,1913,2837,4750,4742,3776,5208,
2165,YGR057C,1405,3349,4754,1899,687,3042,
2166,YOR180C,2812,1942,4754,5102,4167,4481,
2167,YGR048W,2795,1960,4755,4903,4519,2494,
2168,YOR381W-A,1766,2992,4758,1719,3479,2254,
2169,YGL171W,2570,2188,4758,1862,1184,1558,
2170,YGR199W,1896,2867,4763,3078,1692,4080,
2171,YGR236C,1634,3129,4763,4524,2868,1216,
2172,YJL222W-B,1414,3350,4764,1387,1558,4071,
2173,YKL160W,3521,1243,4764,4359,3746,2562,
2174,YIL164C,781,3984,4765,5840,5759,3053,
2175,YHR001W-A,1268,3498,4766,1793,395,4421,
2176,YKL130C,3667,1100,4767,2824,3982,2780,
2177,YHR030C,2798,1970,4768,3744,2915,3503,
2178,YFL021C-A,1968,2803,4771,6660,6591,6279,
2179,YLR129W,2175,2597,4772,1854,1169,1840,
2180,YBR231C,968,3809,4777,6356,6476,3943,
2181,YOR216C,2690,2095,4785,2129,3035,1092,
2182,YJR154W,2250,2535,4785,4221,4631,4771,
2183,YGL060W,573,4223,4796,2155,2817,2405,
2184,YKR020W,2236,2560,4796,3947,5307,1286,
2185,YHL038C,1627,3169,4796,3707,5006,3344,
2186,YLR212C,2221,2576,4797,3775,4889,3543,
2187,YPL012W,2034,2763,4797,1228,630,1499,
2188,YGL184C,1740,3060,4800,4014,5014,3698,
2189,YDR135C,1569,3232,4801,2419,1877,2112,
2190,YLR290C,2190,2612,4802,3096,1223,2915,
2191,YEL075C,2748,2055,4803,4230,4882,1305,
2192,YER121W,2234,2570,4804,1885,1490,2524,
2193,YDR501W,1050,3754,4804,4383,3059,2931,
2194,YPR085C,782,4023,4805,4254,4071,5123,
2195,YJL214W,2361,2446,4807,1077,1109,1315,
2196,YKR053C,681,4126,4807,4487,4770,5311,
2197,YCL020W,1984,2825,4809,1119,945,2154,
2198,YCL052C,1541,3269,4810,3786,3029,3439,
2199,YER041W,673,4137,4810,3038,3707,4417,
2200,YDR231C,3074,1737,4811,5767,6071,2826,
2201,YMR304W,2354,2460,4814,2052,2106,2092,
2202,YDL188C,2541,2284,4825,1849,2846,2943,
2203,YIL155C,2540,2286,4826,3391,5925,1338,
2204,YKL190W,3278,1550,4828,3120,5011,1605,
2205,YGL017W,2237,2591,4828,5245,5384,4847,
2206,YER139C,2224,2604,4828,3446,1579,2738,
2207,YOR015W,1597,3234,4831,1045,1022,5116,
2208,YDR171W,3275,1560,4835,2337,3841,1070,
2209,YHR201C,2171,2665,4836,3985,4732,2176,
2210,YGR059W,2208,2628,4836,1418,1267,1561,
2211,YBR049C,1777,3061,4838,975,764,1191,
2212,YJL075C,1406,3434,4840,5462,2302,5900,
2213,YPL014W,2169,2672,4841,4373,5128,4056,
2214,YCL058C,3729,1113,4842,3525,5931,5547,
2215,YHR196W,2410,2432,4842,1152,488,1384,
2216,YKL075C,1297,3545,4842,1835,1706,2108,
2217,YKL203C,2383,2461,4844,2551,1792,2659,
2218,YBR084W,1270,3577,4847,1039,1346,1040,
2219,YGL014W,2063,2784,4847,1967,1086,2692,
2220,YDR354W,3672,1177,4849,2965,4515,3097,
2221,YJR042W,1000,3850,4850,3501,1997,4141,
2222,YLR323C,2261,2590,4851,5768,5867,4189,
2223,YGL069C,1899,2952,4851,5619,5517,3554,
2224,YOL161C,2457,2395,4852,172,790,186,
2225,YBL035C,1550,3302,4852,3190,2493,2052,
2226,YJL011C,2332,2522,4854,5214,4851,4735,
2227,YIR007W,887,3969,4856,3818,3309,3801,
2228,YFR008W,2647,2210,4857,4434,3600,1876,
2229,YBL095W,3467,1391,4858,5636,5276,4164,
2230,YOL090W,2414,2445,4859,1352,813,1282,
2231,YGL006W,2861,2000,4861,2073,1594,1705,
2232,YPL217C,2622,2240,4862,1205,827,925,
2233,YMR182C,1665,3198,4863,3813,5059,3765,
2234,YGR063C,3321,1542,4863,5845,5133,5268,
2235,YPL015C,3605,1259,4864,4522,4783,3635,
2236,YPL118W,1823,3042,4865,2103,1601,1756,
2237,YDR228C,1659,3209,4868,1568,1499,2036,
2238,YOR112W,937,3931,4868,4191,2735,4245,
2239,YBR142W,2763,2105,4868,1434,1183,1150,
2240,YHR182W,1956,2913,4869,3713,3667,3280,
2241,YBR017C,3058,1812,4870,2848,2392,2536,
2242,YOR257W,2499,2373,4872,5435,4884,2975,
2243,YCL045C,1364,3512,4876,2024,2797,2087,
2244,YBR229C,1321,3556,4877,1395,2248,2229,
2245,YNL334C,2155,2722,4877,3498,3833,3713,
2246,YKR065C,3639,1241,4880,1632,2476,2189,
2247,YOR128C,3578,1304,4882,1432,980,1415,
2248,YGR030C,1481,3402,4883,902,853,1773,
2249,YDL238C,1883,3001,4884,5212,5557,4345,
2250,YGR245C,3447,1438,4885,1076,1196,931,
2251,YDR378C,3610,1275,4885,4674,5391,4197,
2252,YGL115W,3614,1278,4892,2182,3974,1870,
2253,YCR072C,2225,2670,4895,1742,2528,2695,
2254,YDR117C,2004,2897,4901,1437,1965,1508,
2255,YBR258C,3066,1835,4901,2748,3037,2144,
2256,YDL047W,2983,1921,4904,4869,5776,3673,
2257,YNL123W,3303,1601,4904,1291,899,1612,
2258,YJL085W,2423,2481,4904,1893,2287,2540,
2259,YGR120C,2797,2110,4907,2794,3439,3946,
2260,YKL183W,3096,1815,4911,5898,6363,3841,
2261,YBR213W,2387,2533,4920,6226,6563,3617,
2262,YNR013C,2936,1985,4921,1456,3831,2304,
2263,YEL031W,3960,961,4921,608,409,692,
2264,YOR325W,2174,2748,4922,5190,5974,5292,
2265,YMR089C,2629,2298,4927,1765,1537,1189,
2266,YHR031C,1576,3352,4928,4077,3511,2132,
2267,YGR032W,3009,1922,4931,900,564,1284,
2268,YGR091W,2733,2201,4934,3648,3194,2515,
2269,YKL061W,3030,1908,4938,3669,2247,4204,
2270,YDR456W,2059,2879,4938,1796,1726,2165,
2271,YJL077W-B,2477,2462,4939,1207,4139,5388,
2272,YPR108W,4231,709,4940,1630,810,1121,
2273,YOL029C,1790,3153,4943,4035,4166,4690,
2274,YIL103W,2551,2392,4943,1334,909,1469,
2275,YMR042W,2654,2291,4945,6504,6614,4577,
2276,YJL183W,2590,2355,4945,1600,1773,1860,
2277,YKL045W,2288,2658,4946,4668,4691,2759,
2278,YJR093C,1818,3133,4951,4112,3475,4236,
2279,YNL084C,2205,2749,4954,1011,826,1518,
2280,YJL169W,3612,1345,4957,1146,415,2303,
2281,YMR189W,3125,1837,4962,1117,917,1802,
2282,YOL062C,1994,2968,4962,3597,4527,4341,
2283,YOR120W,3995,967,4962,913,1538,1604,
2284,YBR176W,2584,2382,4966,2846,2530,2677,
2285,YGR083C,2516,2451,4967,2739,1372,2077,
2286,YDL092W,3414,1554,4968,2831,2524,1821,
2287,YKR023W,1872,3098,4970,3145,1615,2409,
2288,YLR141W,756,4216,4972,6599,6637,5975,
2289,YKL114C,2986,1987,4973,3162,1673,1735,
2290,YOR177C,1840,3134,4974,3081,3349,2481,
2291,YDR062W,2741,2235,4976,893,789,1438,
2292,YPR200C,2533,2443,4976,2853,2260,4793,
2293,YMR015C,1843,3136,4979,328,110,433,
2294,YDL106C,1169,3810,4979,1777,1562,2852,
2295,YCL017C,3822,1161,4983,828,1182,957,
2296,YDR364C,1003,3982,4985,3069,3173,4621,
2297,YDR049W,2273,2715,4988,3671,3691,2151,
2298,YKL215C,3188,1804,4992,3476,2780,2315,
2299,YLR190W,2449,2543,4992,4698,4622,2419,
2300,YML088W,1517,3477,4994,4604,4199,4477,
2301,YCR092C,3546,1448,4994,4555,3682,4453,
2302,YKR079C,1253,3743,4996,1597,1395,1967,
2303,YBR255C-A,3199,1798,4997,2223,1971,2369,
2304,YKL195W,3671,1334,5005,1639,1363,1293,
2305,YFR055W,1920,3085,5005,4078,3756,4016,
2306,YGL161C,2817,2189,5006,5113,5631,3457,
2307,YJR044C,2811,2199,5010,1454,1614,4070,
2308,YKR105C,2757,2256,5013,4051,4670,5253,
2309,YOR126C,3153,1866,5019,4187,3814,2545,
2310,YBR067C,2266,2754,5020,307,236,281,
2311,YHR076W,3596,1425,5021,1839,2580,1710,
2312,YOL159C,1694,3329,5023,1865,587,3524,
2313,YIR019C,1457,3567,5024,463,499,700,
2314,YNL320W,2037,2989,5026,3198,4145,5134,
2315,YDL230W,2092,2936,5028,5658,6062,3671,
2316,YDR320C,1513,3515,5028,2264,2142,2203,
2317,YDR285W,1200,3830,5030,2782,1125,2581,
2318,YDL240C-A,2854,2184,5038,2022,4151,1719,
2319,YBR037C,2525,2516,5041,6055,5928,4244,
2320,YFR024C-A,2717,2324,5041,1253,1206,1125,
2321,YDL119C,1613,3431,5044,5814,4245,5663,
2322,YGR095C,3487,1557,5044,5065,4827,4311,
2323,YJR020W,3295,1751,5046,5812,5764,4469,
2324,YOL119C,2616,2431,5047,4660,3078,3527,
2325,YDR373W,3961,1087,5048,2029,1331,2423,
2326,YGL167C,3544,1506,5050,991,818,1536,
2327,YDL091C,2653,2398,5051,2863,3220,3862,
2328,YHR209W,2998,2053,5051,3958,2283,5347,
2329,YLR324W,2887,2169,5056,4499,4309,3178,
2330,YBL022C,3130,1928,5058,1485,2127,1217,
2331,YJR153W,2950,2111,5061,1494,1661,1737,
2332,YDR232W,4079,991,5070,1519,4476,990,
2333,YOR160W,2439,2633,5072,2466,1470,2789,
2334,YJR102C,3595,1479,5074,2254,2542,3134,
2335,YHL004W,3754,1320,5074,2680,4130,1362,
2336,YGL025C,1506,3569,5075,5919,5755,3472,
2337,YLR222C,2885,2194,5079,1271,686,1976,
2338,YMR097C,1067,4016,5083,4532,3449,5359,
2339,YBR029C,2989,2094,5083,1609,2853,2118,
2340,YNR029C,2379,2706,5085,3804,4697,3106,
2341,YOR115C,2814,2272,5086,4320,2751,3410,
2342,YNL137C,2944,2144,5088,2258,1438,2323,
2343,YDL007W,1710,3387,5097,2814,1832,1655,
2344,YGR184C,1958,3140,5098,2224,1545,3747,
2345,YMR269W,3218,1880,5098,4644,3286,3269,
2346,YIL064W,2521,2578,5099,5027,5448,4412,
2347,YDR105C,2248,2852,5100,4622,3051,5206,
2348,YGR269W,3090,2010,5100,4924,5149,5626,
2349,YDL085W,3154,1946,5100,4939,5188,2089,
2350,YLR356W,1933,3170,5103,3617,3268,3044,
2351,YPL084W,3035,2073,5108,3299,1454,2245,
2352,YFL013C,3162,1948,5110,4881,4633,2068,
2353,YPR098C,2857,2254,5111,1884,1224,3080,
2354,YCL055W,1616,3499,5115,1504,1216,2017,
2355,YNR004W,3335,1787,5122,1268,1356,1798,
2356,YPR037C,3957,1172,5129,6106,6368,2508,
2357,YNL125C,2320,2810,5130,3194,4443,2140,
2358,YKL065C,2631,2500,5131,2916,4276,1791,
2359,YIL125W,4307,827,5134,818,554,839,
2360,YKL019W,3660,1475,5135,4718,6029,3831,
2361,YDR428C,2191,2947,5138,2113,1164,3270,
2362,YOL136C,1604,3539,5143,1438,1856,2739,
2363,YGR075C,2132,3011,5143,1440,1513,2746,
2364,YPR167C,3029,2116,5145,2387,2884,2326,
2365,YGL084C,2328,2818,5146,1311,1672,1933,
2366,YPL032C,3087,2059,5146,1780,1901,2297,
2367,YMR211W,1905,3244,5149,2057,1714,4804,
2368,YOR165W,3393,1759,5152,1467,923,1451,
2369,YKL143W,2912,2242,5154,1896,1683,1687,
2370,YGR158C,3750,1405,5155,2472,3737,2268,
2371,YPL233W,3788,1369,5157,2854,5451,1413,
2372,YDR284C,3887,1270,5157,2193,3014,3289,
2373,YGL173C,3508,1651,5159,1071,736,1152,
2374,YGL098W,3077,2085,5162,3918,2249,2719,
2375,YDR449C,2156,3010,5166,1187,992,1406,
2376,YEL040W,2402,2770,5172,634,817,1809,
2377,YNL087W,2627,2547,5174,1952,1816,1981,
2378,YCL011C,2769,2405,5174,2009,4585,2012,
2379,YIL108W,3204,1971,5175,4261,5298,3019,
2380,YGR172C,2390,2786,5176,1520,1193,3648,
2381,YOR228C,1641,3536,5177,5555,5583,5600,
2382,YDL161W,3360,1818,5178,4190,3133,1591,
2383,YOR159C,2965,2219,5184,5163,4950,1941,
2384,YLR137W,2230,2956,5186,6156,6394,5130,
2385,YOR173W,3860,1327,5187,2190,4710,1589,
2386,YBR212W,1313,3876,5189,4825,4272,3577,
2387,YOR347C,1935,3258,5193,5239,5573,2435,
2388,YLR142W,3046,2148,5194,1587,4158,1087,
2389,YGR042W,1330,3867,5197,5298,4821,4029,
2390,YJR150C,1556,3641,5197,519,425,587,
2391,YKL088W,1574,3624,5198,5292,4154,2426,
2392,YOR139C,1711,3487,5198,5606,5758,3620,
2393,YGR070W,2651,2552,5203,3858,2167,4463,
2394,YMR020W,1404,3800,5204,2536,3104,4118,
2395,YJR040W,2762,2442,5204,3515,3359,3846,
2396,YOL027C,3384,1825,5209,2084,3289,1035,
2397,YOR192C-A,2532,2677,5209,1056,762,2164,
2398,YBR183W,1140,4072,5212,4419,4794,3582,
2399,YOR143C,2391,2824,5215,1538,1863,2792,
2400,YJL206C,1822,3394,5216,2813,3668,4054,
2401,YGR202C,3205,2015,5220,3987,5630,1728,
2402,YOR361C,2133,3093,5226,427,343,470,
2403,YCL061C,2146,3082,5228,3328,2862,1945,
2404,YNL206C,3209,2025,5234,2587,2812,1797,
2405,YMR114C,3836,1399,5235,4057,4762,3437,
2406,YMR128W,2593,2645,5238,1736,1392,1639,
2407,YDR077W,705,4534,5239,240,259,301,
2408,YHR132C,2421,2819,5240,2548,4275,2525,
2409,YJL186W,2738,2502,5240,2883,4580,2370,
2410,YOR174W,3602,1641,5243,3452,4360,2274,
2411,YHR192W,3781,1465,5246,4849,5411,4786,
2412,YDL117W,1017,4230,5247,3350,1890,2901,
2413,YOL164W,3025,2229,5254,5522,5644,5309,
2414,YBL093C,2351,2904,5255,5775,5434,3935,
2415,YIR024C,2665,2592,5257,3027,1812,1442,
2416,YCR037C,1941,3320,5261,1415,1345,1637,
2417,YLR393W,3105,2159,5264,4877,5095,2468,
2418,YBR295W,2813,2454,5267,3316,4471,3086,
2419,YNL273W,1990,3277,5267,2658,2195,2911,
2420,YOR166C,3136,2132,5268,1357,885,1968,
2421,YBR159W,4481,788,5269,825,610,847,
2422,YAR060C,1854,3415,5269,5438,5549,6196,
2423,YBR039W,3484,1786,5270,416,209,341,
2424,YIL075C,3387,1885,5272,1534,1145,1428,
2425,YMR012W,4646,632,5278,800,731,747,
2426,YLR407W,1540,3739,5279,5143,5142,5088,
2427,YLR157C,2919,2363,5282,2807,3652,1492,
2428,YGR077C,2679,2606,5285,3945,5210,5067,
2429,YBR274W,1947,3339,5286,2146,1893,4005,
2430,YNR027W,3329,1958,5287,6112,6270,5779,
2431,YKR085C,2272,3016,5288,5064,5788,2773,
2432,YMR028W,3075,2214,5289,3281,2776,2949,
2433,YDL057W,2055,3236,5291,5552,4128,5424,
2434,YGR255C,1997,3295,5292,2746,2079,1893,
2435,YGR160W,3900,1393,5293,2556,1500,1424,
2436,YLR003C,3584,1713,5297,2279,1410,3290,
2437,YHR083W,3763,1536,5299,5241,5976,4281,
2438,YGR271W,1900,3400,5300,1938,1226,2233,
2439,YJL156C,1495,3807,5302,3878,1910,3925,
2440,YKR104W,1572,3731,5303,3810,2545,5191,
2441,YER179W,3000,2303,5303,3262,1189,2721,
2442,YGL185C,3725,1579,5304,4215,4197,4484,
2443,YAL059C-A,2872,2433,5305,1451,4248,6349,
2444,YOR286W,2973,2332,5305,3826,3277,3293,
2445,YFR012W,2204,3102,5306,4639,3743,6058,
2446,YOL054W,1932,3377,5309,4033,5541,3853,
2447,YML042W,3415,1894,5309,1843,2245,2252,
2448,YNR074C,4007,1305,5312,4458,4224,3330,
2449,YHR079C-A,3117,2196,5313,1201,541,517,
2450,YDR216W,2274,3041,5315,2020,1509,3217,
2451,YMR014W,2879,2437,5316,2173,1828,1166,
2452,YJR049C,3500,1817,5317,4613,4376,3961,
2453,YKR002W,2413,2907,5320,2159,1930,2627,
2454,YPR092W,2198,3122,5320,1792,4089,5356,
2455,YBR132C,1044,4276,5320,3646,3700,3606,
2456,YJL194W,1275,4048,5323,5099,4819,3907,
2457,YBR014C,4165,1158,5323,2389,1494,1944,
2458,YPL050C,4159,1167,5326,827,1039,858,
2459,YLR450W,2595,2735,5330,1813,2217,2703,
2460,YHR055C,3402,1931,5333,1241,3385,2333,
2461,YER104W,2435,2899,5334,2976,4463,4898,
2462,YCR021C,2608,2727,5335,870,1197,1077,
2463,YOR226C,3245,2091,5336,5201,6155,3188,
2464,YGR065C,1138,4199,5337,1092,998,2602,
2465,YGL028C,2742,2596,5338,573,422,719,
2466,YPL165C,1475,3864,5339,2541,1927,4557,
2467,YBR280C,2323,3019,5342,4274,4420,4470,
2468,YHL030W,2613,2732,5345,3286,2462,3076,
2469,YML036W,2671,2675,5346,5022,5074,3919,
2470,YGR142W,2745,2601,5346,1505,865,1144,
2471,YOR048C,1491,3855,5346,1658,2396,2008,
2472,YHR137C-A,2431,2916,5347,5787,5440,4086,
2473,YNL168C,3311,2037,5348,1981,4335,1555,
2474,YMR008C,2644,2705,5349,620,659,922,
2475,YGR247W,3918,1435,5353,5826,5665,5846,
2476,YAL042W,3915,1439,5354,6144,6396,3633,
2477,YKL050C,2048,3307,5355,4311,3994,2234,
2478,YBR111W-A,3405,1950,5355,2515,960,2947,
2479,YMR255W,3107,2248,5355,2321,2877,2851,
2480,YIL019W,3155,2200,5355,3413,4316,2148,
2481,YJL104W,2065,3293,5358,6147,3092,4432,
2482,YBR058C,3739,1623,5362,1706,1589,2619,
2483,YKR016W,2791,2574,5365,2496,3283,1663,
2484,YNL151C,2792,2573,5365,2238,1510,1464,
2485,YJL116C,2242,3127,5369,685,769,884,
2486,YDR083W,3628,1742,5370,1104,526,878,
2487,YMR236W,3200,2170,5370,6425,6248,5541,
2488,YDR005C,1882,3493,5375,4176,2517,4795,
2489,YFL041W,1977,3406,5383,3035,3665,2966,
2490,YHR016C,1832,3551,5383,3351,2873,3108,
2491,YPL095C,1676,3712,5388,2708,2500,2744,
2492,YIL047C,1642,3746,5388,4313,5626,3179,
2493,YLR362W,2444,2944,5388,3258,2494,2070,
2494,YPL204W,2987,2404,5391,2709,3948,1803,
2495,YOR316C,2566,2826,5392,3030,3838,2988,
2496,YMR259C,2465,2928,5393,2179,1680,3130,
2497,YGL022W,3338,2056,5394,1328,4798,987,
2498,YGR243W,2282,3114,5396,5992,5049,3730,
2499,YMR159C,3258,2138,5396,4844,3260,3253,
2500,YLR155C,3073,2325,5398,2809,3651,1493,
2501,YMR161W,3888,1510,5398,4610,4462,2532,
2502,YDR379C-A,3070,2330,5400,1972,3181,4535,
2503,YDL200C,1542,3862,5404,3959,1365,2731,
2504,YDR387C,2691,2716,5407,4382,3386,5250,
2505,YIL161W,2075,3332,5407,3029,3548,2978,
2506,YER060W-A,2459,2948,5407,1442,1149,2447,
2507,YLR440C,1586,3823,5409,4262,4508,3236,
2508,YJL053W,2275,3135,5410,2986,4006,3466,
2509,YDR120C,3309,2103,5412,2991,3387,2174,
2510,YHR199C,4067,1347,5414,5904,6103,3427,
2511,YGL020C,4351,1063,5414,2145,1693,1171,
2512,YER021W,3742,1672,5414,1477,1920,1458,
2513,YIL156W-A,2334,3080,5414,6247,6239,5484,
2514,YGL068W,3798,1619,5417,1252,2223,616,
2515,YBR113W,2416,3002,5418,5561,5022,5803,
2516,YGR136W,3365,2054,5419,5032,1740,4551,
2517,YPL169C,2445,2975,5420,4740,4067,3233,
2518,YNR058W,4088,1332,5420,3071,4713,3090,
2519,YDR097C,1500,3921,5421,2191,971,1993,
2520,YOL113W,3746,1676,5422,4912,4060,5499,
2521,YOR254C,2001,3425,5426,1007,576,1613,
2522,YHR042W,4058,1378,5436,1522,5398,841,
2523,YPL054W,1347,4089,5436,2456,2044,2730,
2524,YNL097C,2891,2546,5437,5328,5924,2305,
2525,YJR086W,2851,2588,5439,4744,2029,5598,
2526,YLR064W,4380,1060,5440,4994,5005,5006,
2527,YHR034C,1669,3771,5440,6449,6448,4694,
2528,YLR160C,2858,2584,5442,2806,3654,1494,
2529,YDR347W,2796,2646,5442,5991,5586,5187,
2530,YOR035C,1741,3702,5443,4324,4124,3075,
2531,YOL059W,4318,1126,5444,1507,4487,1312,
2532,YCL048W-A,1064,4381,5445,2891,3527,909,
2533,YDR100W,4602,844,5446,3402,4537,3006,
2534,YKL041W,4062,1385,5447,4107,3809,2559,
2535,YDL150W,2621,2827,5448,4375,4981,1771,
2536,YOR148C,3128,2326,5454,4651,4640,4283,
2537,YDR022C,2244,3210,5454,2405,3126,3643,
2538,YGL015C,3778,1682,5460,2512,3093,4091,
2539,YHR212C,1943,3517,5460,5437,5551,6195,
2540,YJL071W,3807,1655,5462,5003,4434,5009,
2541,YAL059W,3006,2457,5463,2081,2251,1238,
2542,YAL015C,3266,2197,5463,5558,5416,3306,
2543,YGL151W,1562,3901,5463,1976,1563,2702,
2544,YML068W,1845,3620,5465,4099,3373,5743,
2545,YER093C-A,2375,3090,5465,5283,6000,5218,
2546,YCR093W,1816,3652,5468,1445,1080,1608,
2547,YDL120W,2704,2769,5473,5686,4739,5383,
2548,YKL154W,3449,2027,5476,3390,1543,1684,
2549,YLL013C,2670,2806,5476,1886,3372,1545,
2550,YKR011C,362,5115,5477,1250,1190,2920,
2551,YOR004W,3160,2318,5478,3798,4048,2575,
2552,YBR056W-A,3433,2046,5479,1565,1030,6050,
2553,YDR290W,3119,2362,5481,925,670,1426,
2554,YLL028W,2860,2621,5481,1773,2933,1620,
2555,YMR109W,3331,2154,5485,1459,806,1375,
2556,YLR013W,1778,3708,5486,5127,4045,4343,
2557,YCR015C,2850,2640,5490,1511,1010,2329,
2558,YMR093W,2600,2891,5491,2928,2519,3046,
2559,YNL300W,1030,4461,5491,500,1703,557,
2560,YDR261C,2307,3186,5493,2671,2890,2310,
2561,YDL134C,2868,2626,5494,2483,2650,3860,
2562,YOR074C,3566,1929,5495,1121,1170,1162,
2563,YNL026W,2021,3475,5496,3901,1966,4176,
2564,YER157W,2779,2718,5497,1393,1621,1470,
2565,YDR080W,1890,3609,5499,1590,977,3194,
2566,YOR285W,4355,1147,5502,2067,1648,2153,
2567,YDR034C-C,2920,2582,5502,1026,777,2127,
2568,YCR084C,3322,2181,5503,2895,4323,1514,
2569,YCR005C,2222,3282,5504,1301,859,1443,
2570,YOR207C,2574,2931,5505,687,270,917,
2571,YDR163W,1537,3968,5505,6448,5220,4706,
2572,YLR114C,1100,4405,5505,2615,2341,2568,
2573,YNL035C,3179,2328,5507,1029,2124,1398,
2574,YDL026W,2000,3507,5507,6025,5737,6438,
2575,YJR152W,3659,1850,5509,1615,1402,2021,
2576,YGR090W,2949,2561,5510,1114,760,1407,
2577,YPR086W,3959,1556,5515,3562,2836,2313,
2578,YER146W,4014,1501,5515,6409,6470,2258,
2579,YNL094W,2178,3338,5516,1685,1895,2284,
2580,YDR348C,1982,3535,5517,3606,3808,3287,
2581,YNL268W,3772,1747,5519,973,1907,757,
2582,YER060W,3111,2408,5519,2925,2062,2583,
2583,YGR251W,3201,2319,5520,5810,5245,2809,
2584,YGL047W,4137,1386,5523,5433,5781,3352,
2585,YJR013W,2481,3045,5526,4889,4421,5554,
2586,YML100W,3280,2247,5527,3686,5288,1998,
2587,YNL107W,2669,2858,5527,2974,2043,4206,
2588,YAL021C,3350,2177,5527,5021,5966,2356,
2589,YAR019W-A,2515,3012,5527,6133,5458,5990,
2590,YJL108C,617,4914,5531,1572,1038,3039,
2591,YKL027W,3702,1831,5533,3551,3735,3065,
2592,YGL223C,2547,2987,5534,1966,3618,2801,
2593,YPR093C,1870,3666,5536,5920,6413,5899,
2594,YKL144C,2847,2694,5541,2876,2425,3797,
2595,YOL018C,1888,3654,5542,4979,4209,3942,
2596,YLR025W,4827,716,5543,5322,4559,2342,
2597,YDL237W,3359,2185,5544,2581,2921,2843,
2598,YMR054W,3330,2216,5546,2062,2634,1688,
2599,YLL043W,2308,3242,5550,2931,2173,2534,
2600,YCR020W-B,3762,1789,5551,2827,797,2429,
2601,YBR279W,2952,2602,5554,1517,1854,890,
2602,YCR042C,1130,4424,5554,2670,2093,3271,
2603,YDR210W-B,1380,4178,5558,1740,1750,4007,
2604,YBL042C,2069,3490,5559,2158,4035,1839,
2605,YER152C,4064,1499,5563,6531,6535,5310,
2606,YIL073C,1282,4282,5564,4025,3131,4229,
2607,YML031C-A,1936,3628,5564,4401,6080,6170,
2608,YDL166C,3631,1935,5566,4378,5257,1872,
2609,YKL093W,2061,3508,5569,5671,4467,4939,
2610,YPL186C,4078,1491,5569,3121,1741,1292,
2611,YCL005W-A,2676,2893,5569,1883,2993,3651,
2612,YDL204W,4227,1342,5569,1942,4943,1404,
2613,YLR089C,4536,1034,5570,1083,944,963,
2614,YHR053C,3609,1961,5570,1240,3389,2340,
2615,YPL175W,2685,2889,5574,4069,3750,4564,
2616,YKL017C,2114,3460,5574,1988,2859,1656,
2617,YGR278W,1206,4369,5575,4356,4604,3884,
2618,YLR210W,1962,3615,5577,3367,2345,4138,
2619,YDR041W,2268,3317,5585,4250,3326,3273,
2620,YBR107C,2979,2607,5586,4999,5709,4139,
2621,YDL059C,2531,3055,5586,5962,5778,3654,
2622,YDR497C,2675,2911,5586,1483,3188,1263,
2623,YMR001C,1514,4074,5588,1561,932,2309,
2624,YHR168W,2794,2797,5591,5149,5168,4424,
2625,YPL086C,3452,2140,5592,861,302,1020,
2626,YMR003W,1505,4091,5596,4260,3275,4428,
2627,YML051W,2153,3444,5597,3829,4408,4148,
2628,YLR100W,4398,1199,5597,3963,5163,2577,
2629,YIR030C,3989,1609,5598,5056,3532,4247,
2630,YER135C,2506,3094,5600,1980,1733,2638,
2631,YDR218C,2871,2729,5600,2484,2225,2374,
2632,YCR064C,2488,3116,5604,6201,6282,6120,
2633,YDL058W,3603,2001,5604,2139,1599,1369,
2634,YOR356W,3737,1870,5607,3136,3085,1782,
2635,YBL021C,2462,3148,5610,6526,6505,5939,
2636,YIL166C,2028,3584,5612,3405,2982,3105,
2637,YJL170C,3465,2150,5615,5173,5973,4289,
2638,YLR022C,3293,2322,5615,3478,2551,3013,
2639,YJL125C,3008,2608,5616,2689,2353,3507,
2640,YFL034W,2509,3107,5616,2501,2282,2611,
2641,YNL166C,3863,1753,5616,4451,4828,2690,
2642,YML095C,3530,2086,5616,3387,3458,5232,
2643,YGL004C,3497,2123,5620,3665,4119,2924,
2644,YLR052W,2054,3566,5620,2529,3344,1823,
2645,YLR158C,3145,2478,5623,2812,3653,1490,
2646,YPR160W,3501,2124,5625,652,906,724,
2647,YIL057C,2708,2918,5626,1667,4654,812,
2648,YFL002C,2522,3105,5627,3845,2469,2663,
2649,YDR538W,4269,1358,5627,4512,3162,2863,
2650,YEL076C,2331,3297,5628,5967,6055,6289,
2651,YBR291C,3292,2336,5628,3620,2637,3732,
2652,YIL036W,1981,3653,5634,3056,3481,3360,
2653,YNR015W,2524,3112,5636,5404,6142,2002,
2654,YKL005C,2823,2813,5636,3844,3304,2172,
2655,YPL110C,3150,2492,5642,4104,2583,3011,
2656,YDR363W,2318,3325,5643,2498,2920,3081,
2657,YKL214C,4910,736,5646,4047,5048,1290,
2658,YJL195C,2805,2844,5649,5782,5866,5178,
2659,YNR026C,2283,3366,5649,3746,4445,3116,
2660,YER150W,2761,2890,5651,2211,1803,1640,
2661,YMR233W,3203,2450,5653,3677,3812,2241,
2662,YNL195C,4495,1159,5654,3083,5439,1959,
2663,YLL062C,2497,3159,5656,3974,4632,3279,
2664,YPR118W,2915,2741,5656,2064,1994,1975,
2665,YNL204C,1314,4343,5657,4144,4573,3066,
2666,YDL239C,1465,4193,5658,3654,1991,3591,
2667,YGL220W,4337,1324,5661,6249,6052,5198,
2668,YDR518W,4429,1242,5671,1033,1328,1026,
2669,YOR075W,1880,3792,5672,1741,1146,1919,
2670,YDR481C,4101,1573,5674,3103,4194,1912,
2671,YDR236C,3811,1865,5676,2594,2851,4522,
2672,YPR033C,3564,2112,5676,514,377,479,
2673,YAL064W,2102,3575,5677,5405,5205,6032,
2674,YGL258W-A,2213,3467,5680,4432,4298,4866,
2675,YGL158W,1112,4569,5681,3181,4413,3033,
2676,YOL015W,1015,4667,5682,2071,1641,4292,
2677,YMR247C,2753,2932,5685,2227,1409,3267,
2678,YKR083C,3589,2098,5687,4627,1530,4266,
2679,YCR024C,2192,3500,5692,2471,1820,3087,
2680,YOR124C,4190,1502,5692,2379,1622,2579,
2681,YGL196W,4219,1477,5696,3323,2111,3941,
2682,YMR149W,3636,2061,5697,1531,3444,887,
2683,YKR039W,3047,2654,5701,575,677,709,
2684,YKL217W,1742,3962,5704,1845,1485,1479,
2685,YMR215W,2619,3087,5706,815,1064,1075,
2686,YKR030W,2349,3358,5707,3710,3025,4884,
2687,YCR028C,2925,2782,5707,3053,2866,3423,
2688,YGR084C,2260,3448,5708,5514,4216,4282,
2689,YFR049W,3468,2244,5712,5425,4886,4434,
2690,YAL026C,3103,2611,5714,1053,879,1306,
2691,YPL064C,3323,2393,5716,4573,3670,2991,
2692,YDR056C,3992,1725,5717,2815,1565,1718,
2693,YOR295W,2099,3621,5720,5806,5356,5931,
2694,YCR013C,2492,3228,5720,6390,4769,3995,
2695,YML098W,3060,2661,5721,6335,5912,3513,
2696,YCR099C,2672,3051,5723,2623,1885,2865,
2697,YGR224W,3062,2666,5728,3875,4294,3320,
2698,YBR008C,2846,2885,5731,2425,2371,2829,
2699,YNL157W,2880,2851,5731,5315,4833,5849,
2700,YIR008C,2660,3074,5734,2061,2336,2859,
2701,YFR043C,3176,2558,5734,2738,2899,3909,
2702,YER082C,4123,1615,5738,2415,1914,1502,
2703,YER069W,3861,1881,5742,1270,1248,1232,
2704,YHR126C,3826,1917,5743,2732,2514,2285,
2705,YIL111W,3513,2230,5743,5563,3422,2914,
2706,YOL017W,1095,4649,5744,3718,3346,4855,
2707,YKL116C,927,4821,5748,5133,4281,5545,
2708,YDR243C,2984,2765,5749,1806,1262,1353,
2709,YDR194C,3534,2215,5749,820,578,986,
2710,YHL046C,2479,3271,5750,225,1230,219,
2711,YPR044C,2286,3464,5750,2530,5239,6384,
2712,YDL112W,3879,1873,5752,2704,2340,2755,
2713,YDR021W,3691,2063,5754,1293,660,1874,
2714,YPR156C,3982,1774,5756,605,595,1069,
2715,YLR146W-A,4340,1417,5757,6231,6033,4617,
2716,YBL017C,2041,3719,5760,1818,1663,1875,
2717,YKL096W-A,3063,2698,5761,105,54,129,
2718,YPL059W,4208,1553,5761,4337,4313,2497,
2719,YER066W,2594,3168,5762,2823,3890,5815,
2720,YDR400W,4399,1363,5762,2830,2636,3249,
2721,YNL077W,1709,4054,5763,3791,4961,3818,
2722,YMR004W,1855,3908,5763,1897,2095,2457,
2723,YDR011W,3017,2747,5764,1345,1002,1925,
2724,YOL098C,4091,1678,5769,1130,901,1610,
2725,YHR093W,3191,2579,5770,5921,5295,4150,
2726,YGL143C,1370,4402,5772,4918,4446,3493,
2727,YGL198W,1910,3872,5782,6604,6520,6250,
2728,YGR270W,2687,3095,5782,3220,1978,2487,
2729,YJL126W,3812,1978,5790,5464,5261,5225,
2730,YJL101C,2422,3369,5791,3743,3442,3469,
2731,YIL010W,3148,2650,5798,4291,2575,2163,
2732,YBL102W,4518,1287,5805,5972,5628,5928,
2733,YLR228C,3019,2790,5809,4277,3571,4021,
2734,YLR086W,2579,3230,5809,3589,3005,2379,
2735,YJL128C,2589,3222,5811,3915,3857,3220,
2736,YLL017W,2859,2953,5812,5233,5209,5831,
2737,YPR006C,3825,1988,5813,3434,3251,3206,
2738,YOL080C,3833,1980,5813,2358,3033,1863,
2739,YMR214W,3272,2542,5814,3302,4840,1008,
2740,YGR183C,2736,3083,5819,1243,975,4919,
2741,YBR233W-A,4203,1617,5820,5978,5039,4478,
2742,YLR115W,2134,3687,5821,3792,3016,3776,
2743,YBR043C,3187,2637,5824,4296,3943,4257,
2744,YBR148W,3216,2610,5826,1497,1297,1248,
2745,YDR084C,3814,2012,5826,4082,3640,4811,
2746,YBR021W,1833,3995,5828,1067,993,1788,
2747,YER095W,2931,2898,5829,3309,4042,1807,
2748,YLR012C,2496,3334,5830,750,258,992,
2749,YPR201W,3274,2556,5830,2436,2534,2976,
2750,YNL081C,1444,4391,5835,4761,3940,3100,
2751,YGL191W,3983,1856,5839,949,433,739,
2752,YLL054C,2104,3735,5839,2553,2775,4286,
2753,YOR331C,3464,2377,5841,3851,5695,3840,
2754,YMR324C,2718,3130,5848,3140,3619,5076,
2755,YOL132W,1649,4201,5850,2316,1736,2001,
2756,YLR042C,2408,3442,5850,2428,2852,5080,
2757,YKL166C,3561,2289,5850,1997,3172,2037,
2758,YMR123W,5111,741,5852,3385,5676,3891,
2759,YJR031C,1995,3859,5854,3580,2984,3809,
2760,YLR220W,3925,1930,5855,5449,5186,3465,
2761,YER074W-A,4543,1316,5859,5901,3341,3568,
2762,YDR397C,3791,2068,5859,5954,6184,3268,
2763,YCL029C,3123,2737,5860,5244,5678,2993,
2764,YGL134W,855,5009,5864,5008,4685,4710,
2765,YBR102C,1395,4473,5868,3532,3088,3342,
2766,YGL150C,2014,3856,5870,1198,1646,1086,
2767,YDL179W,1467,4404,5871,4861,4061,4089,
2768,YKL004W,1923,3954,5877,2736,1747,4110,
2769,YCR023C,2184,3695,5879,2382,1397,4871,
2770,YHR084W,623,5256,5879,2864,1534,3822,
2771,YGR271C-A,4295,1584,5879,1864,468,1250,
2772,YMR067C,3254,2625,5879,3232,3039,2673,
2773,YPR133C,4209,1671,5880,1947,1421,1264,
2774,YPL128C,3592,2293,5885,5142,5376,3536,
2775,YGL170C,3560,2329,5889,1604,701,2408,
2776,YIL027C,2935,2954,5889,4238,3028,4600,
2777,YLR007W,2642,3248,5890,5849,5744,4931,
2778,YHR069C-A,3398,2495,5893,5706,6066,5630,
2779,YJL174W,2080,3813,5893,2348,1822,2606,
2780,YPR020W,2337,3560,5897,4229,1704,3644,
2781,YER096W,1565,4334,5899,3416,2165,3203,
2782,YMR062C,4275,1627,5902,1663,2057,1650,
2783,YMR024W,3040,2863,5903,4819,3211,4512,
2784,YIR039C,2135,3777,5912,3657,2943,3243,
2785,YBL043W,1754,4159,5913,2167,4785,2689,
2786,YBR194W,2108,3805,5913,4123,4483,5514,
2787,YOR290C,1837,4079,5916,2463,1962,2205,
2788,YKL164C,724,5192,5916,249,106,247,
2789,YLL058W,4016,1901,5917,5773,5491,3824,
2790,YNR006W,2239,3680,5919,4189,3803,3095,
2791,YKL062W,1716,4204,5920,1608,2081,2737,
2792,YDR213W,3344,2577,5921,5019,4213,3812,
2793,YMR288W,1858,4063,5921,3215,2016,3318,
2794,YOR309C,4116,1807,5923,4717,2301,1762,
2795,YIR029W,4714,1212,5926,3090,3047,2116,
2796,YIR006C,4222,1707,5929,2797,1233,2046,
2797,YHR115C,2118,3811,5929,3280,5351,2869,
2798,YAL056C-A,3237,2697,5934,5430,5682,6023,
2799,YKL018W,3782,2153,5935,3535,3629,3356,
2800,YNL218W,2849,3086,5935,4398,3584,3962,
2801,YMR296C,3386,2551,5937,4574,5981,1664,
2802,YMR178W,4170,1768,5938,3283,1960,3340,
2803,YJL037W,4336,1607,5943,5290,5160,4019,
2804,YMR147W,3304,2642,5946,4489,5124,2674,
2805,YDR417C,3424,2526,5950,6206,5086,5032,
2806,YGR186W,3149,2801,5950,3538,1847,1673,
2807,YGL145W,3271,2679,5950,1786,1199,1920,
2808,YLR439W,3318,2634,5952,4436,6335,2099,
2809,YBR187W,3789,2167,5956,2665,2108,1110,
2810,YCL057W,4598,1360,5958,1468,2597,1359,
2811,YIL065C,3310,2649,5959,6386,6485,4348,
2812,YFL008W,3104,2855,5959,2099,1771,1224,
2813,YMR058W,3751,2209,5960,1191,4599,1489,
2814,YLR187W,2726,3239,5965,4037,3282,3878,
2815,YHR023W,2830,3139,5969,2304,1953,1903,
2816,YBR112C,2650,3321,5971,2467,862,1891,
2817,YLR256W-A,1746,4228,5974,2887,2601,3176,
2818,YIL093C,2735,3240,5975,5156,5645,3096,
2819,YOL066C,3026,2949,5975,4540,5206,3697,
2820,YBR055C,2907,3071,5978,3970,2054,3784,
2821,YAL022C,3740,2239,5979,5611,6339,3686,
2822,YOR121C,2377,3602,5979,1287,5150,5433,
2823,YLR053C,2475,3506,5981,4109,5035,4676,
2824,YJR001W,1460,4521,5981,5015,4722,4529,
2825,YLR143W,3061,2922,5983,1852,1645,2180,
2826,YNR041C,2601,3382,5983,5809,5846,4900,
2827,YNL306W,4453,1532,5985,4705,4121,2930,
2828,YIL134W,2394,3593,5987,5650,5661,5147,
2829,YNL074C,1747,4246,5993,4867,4687,4489,
2830,YNL006W,2536,3459,5995,3782,3577,3292,
2831,YDL160C-A,2662,3335,5997,5893,5847,5041,
2832,YGL095C,3994,2004,5998,2403,1882,2261,
2833,YBR238C,2788,3213,6001,560,631,1023,
2834,YLR083C,3297,2709,6006,999,1091,1717,
2835,YGL016W,3756,2252,6008,1142,786,2040,
2836,YLR225C,3376,2632,6008,2706,2222,2592,
2837,YPR065W,1288,4724,6012,4055,4390,3092,
2838,YBR204C,3855,2160,6015,4733,3902,5264,
2839,YGR055W,3680,2335,6015,741,633,883,
2840,YDR527W,3902,2113,6015,2058,2813,1330,
2841,YIL048W,2325,3692,6017,1536,1004,2100,
2842,YHR140W,2710,3309,6019,2918,1767,2985,
2843,YJR051W,3882,2143,6025,1783,1417,1562,
2844,YLR051C,3234,2791,6025,1416,3010,1547,
2845,YOL052C-A,1544,4481,6025,521,1588,681,
2846,YDL090C,2321,3706,6027,3336,3164,5593,
2847,YMR277W,2620,3408,6028,3796,4838,2343,
2848,YIL003W,4657,1372,6029,5614,4676,4704,
2849,YPL030W,3880,2151,6031,3073,2757,2090,
2850,YJL178C,4642,1392,6034,3278,4273,1598,
2851,YHL002W,2215,3820,6035,4106,2380,3126,
2852,YDR357C,2128,3909,6037,2597,2588,3296,
2853,YLR090W,3371,2667,6038,4326,5512,2111,
2854,YGL186C,1919,4119,6038,3997,3243,4064,
2855,YOR304C-A,4071,1968,6039,5723,4870,3614,
2856,YMR007W,3940,2101,6041,5872,5978,5877,
2857,YPL007C,2415,3627,6042,3503,2668,5103,
2858,YPR189W,2897,3145,6042,2365,1609,2565,
2859,YCL039W,2407,3635,6042,5468,6046,3881,
2860,YNL284C,2376,3675,6051,3647,3621,2267,
2861,YOR329C,2573,3478,6051,3868,2690,4789,
2862,YOL084W,3929,2126,6055,3956,5518,2295,
2863,YAL068C,3033,3022,6055,215,972,220,
2864,YHR195W,2991,3065,6056,4886,5496,5007,
2865,YMR266W,2451,3608,6059,1018,664,1303,
2866,YOR343W-B,1536,4523,6059,1691,1695,3929,
2867,YJR140C,1600,4463,6063,3049,3141,3660,
2868,YNR043W,5747,319,6066,1349,2332,938,
2869,YFL029C,3375,2693,6068,4314,5354,2473,
2870,YKR052C,1577,4491,6068,4017,1987,4656,
2871,YOR103C,4367,1703,6070,2128,860,2382,
2872,YDR195W,2253,3819,6072,2903,2556,2459,
2873,YJR091C,2427,3646,6073,2393,3183,2908,
2874,YOL152W,1182,4891,6073,2840,3434,3630,
2875,YPR194C,3553,2521,6074,1377,845,2276,
2876,YJL048C,3577,2498,6075,3582,4803,4653,
2877,YDL095W,4132,1945,6077,858,2083,1175,
2878,YIL126W,3703,2375,6078,1552,990,943,
2879,YDL042C,2073,4005,6078,3436,3546,2979,
2880,YMR256C,2774,3306,6080,891,345,1350,
2881,YIL169C,3523,2557,6080,469,1191,969,
2882,YML014W,2866,3214,6080,5854,6215,3158,
2883,YNL001W,2482,3599,6081,2018,1077,1906,
2884,YGR195W,3503,2580,6083,3846,5231,3487,
2885,YLR221C,4279,1805,6084,1982,1566,1118,
2886,YGL201C,3604,2480,6084,1547,1161,1868,
2887,YHR090C,2930,3155,6085,2100,1311,2230,
2888,YDL132W,2712,3373,6085,1979,2070,1564,
2889,YPR135W,4272,1814,6086,2293,1827,2146,
2890,YLL006W,2490,3600,6090,4729,4174,4354,
2891,YJL223C,2641,3453,6094,195,796,203,
2892,YOL142W,3693,2402,6095,3107,3932,3627,
2893,YPR114W,2945,3157,6102,1751,5195,2654,
2894,YML009C,4751,1352,6103,5602,4940,2657,
2895,YHR123W,2825,3279,6104,3777,4229,4409,
2896,YGR006W,1829,4283,6112,4459,5146,5379,
2897,YDR289C,1876,4242,6118,1541,896,2224,
2898,YGR005C,4475,1643,6118,1647,1909,844,
2899,YBL103C,2695,3423,6118,2493,1864,2217,
2900,YKL122C,4253,1867,6120,2924,2875,2444,
2901,YCL014W,2151,3970,6121,3382,2840,2994,
2902,YOR189W,4772,1353,6125,5504,4340,4362,
2903,YGR047C,1671,4455,6126,3769,2739,2937,
2904,YPR032W,2873,3254,6127,3930,2769,2927,
2905,YEL020C-B,3504,2624,6128,958,816,2892,
2906,YOR241W,3341,2787,6128,2474,3189,2954,
2907,YGR105W,5476,654,6130,5352,4530,3521,
2908,YLR149C-A,4015,2115,6130,580,331,2861,
2909,YGR274C,867,5264,6131,1585,787,1820,
2910,YNL216W,2166,3966,6132,3193,2600,2888,
2911,YER130C,2810,3323,6133,2181,3918,2798,
2912,YDR149C,3034,3103,6137,3392,4643,4963,
2913,YHR158C,2975,3164,6139,2939,2829,2472,
2914,YNL066W,3993,2146,6139,568,835,611,
2915,YDR261W-B,1293,4846,6139,1824,1737,4183,
2916,YML102W,2485,3655,6140,6536,6447,6198,
2917,YDL005C,2456,3688,6144,1417,3972,1838,
2918,YLR442C,1961,4183,6144,4211,2803,3368,
2919,YKL021C,2538,3606,6144,1013,1024,1472,
2920,YER151C,3493,2653,6146,1577,2211,1300,
2921,YPR160C-A,2090,4058,6148,5693,4283,5734,
2922,YGL033W,2957,3191,6148,3108,1011,1531,
2923,YMR018W,2724,3426,6150,3127,1637,5220,
2924,YGR203W,5133,1017,6150,6663,6667,6316,
2925,YJL013C,2045,4106,6151,4445,3669,3522,
2926,YOR359W,1045,5107,6152,2555,2677,2830,
2927,YCR048W,3706,2453,6159,6367,6543,3900,
2928,YJL192C,2918,3247,6165,2439,3575,1996,
2929,YAL016C-A,4366,1799,6165,3317,4946,2675,
2930,YDR039C,3478,2689,6167,1333,2052,1331,
2931,YPR176C,4339,1828,6167,2898,2495,4525,
2932,YPL271W,1498,4676,6174,1371,214,1734,
2933,YJL093C,3139,3036,6175,4307,3882,4396,
2934,YLR294C,3082,3097,6179,1182,837,3938,
2935,YBL040C,3984,2195,6179,1118,2051,3018,
2936,YDL154W,1678,4504,6182,3574,2756,3743,
2937,YEL064C,2056,4130,6186,3458,3259,4644,
2938,YNL020C,2203,3985,6188,4193,3706,4224,
2939,YPR091C,3707,2484,6191,1669,1598,1896,
2940,YDR242W,4348,1847,6195,2858,2144,3804,
2941,YGL090W,2953,3243,6196,3917,3755,4270,
2942,YER172C-A,3053,3144,6197,6203,6026,6224,
2943,YGR161W-B,1748,4454,6202,1731,1755,4065,
2944,YMR113W,4162,2041,6203,4640,3851,3652,
2945,YHR144C,4533,1670,6203,4067,2648,3151,
2946,YAL011W,1316,4887,6203,4289,4333,2546,
2947,YDR435C,4538,1667,6205,4630,5004,4339,
2948,YMR051C,1463,4745,6208,2715,2176,3213,
2949,YDL089W,2406,3803,6209,1986,1526,2970,
2950,YIL115W-A,3038,3172,6210,1414,1486,2093,
2951,YOR339C,5244,968,6212,5473,3350,5071,
2952,YIL007C,4308,1904,6212,4829,5097,3890,
2953,YKL221W,2997,3217,6214,4743,3751,5894,
2954,YML076C,1266,4950,6216,3135,3036,4082,
2955,YIL146C,2189,4033,6222,4593,3911,3489,
2956,YML127W,3261,2966,6227,5424,5329,3800,
2957,YHR187W,3288,2940,6228,4986,4534,3793,
2958,YHR131W-A,3225,3003,6228,5230,5285,6433,
2959,YBR207W,1834,4396,6230,3290,4738,3157,
2960,YBL033C,2963,3267,6230,6058,6224,5055,
2961,YLR430W,3002,3231,6233,2650,1999,2987,
2962,YGR127W,3475,2758,6233,3505,2675,3856,
2963,YDR001C,3343,2895,6238,1767,1748,2003,
2964,YKL014C,2340,3898,6238,1490,1449,2500,
2965,YPR019W,1898,4340,6238,1697,2478,1600,
2966,YPL206C,2105,4133,6238,3398,4126,4085,
2967,YOR011W,4063,2176,6239,1074,995,1922,
2968,YLR376C,3840,2400,6240,4975,5273,3887,
2969,YHR040W,2425,3815,6240,6353,6428,4671,
2970,YPR040W,4525,1716,6241,4361,6022,3533,
2971,YHL022C,2395,3846,6241,2021,2981,1858,
2972,YNR036C,2940,3301,6241,6430,6330,4370,
2973,YDR291W,2121,4120,6241,2494,2364,3214,
2974,YGR003W,772,5470,6242,3536,3472,4514,
2975,YLL018C-A,2996,3249,6245,5536,6045,3789,
2976,YGL263W,3122,3125,6247,2884,2416,5024,
2977,YHR050W,2558,3689,6247,5720,5520,5565,
2978,YLR410W,3229,3018,6247,2112,2516,2062,
2979,YDR434W,4794,1457,6251,1898,807,2351,
2980,YPL199C,4942,1314,6256,3908,2539,3634,
2981,YOR032C,1511,4747,6258,3463,3647,4491,
2982,YDR141C,2875,3383,6258,3594,3241,4389,
2983,YGR038C-A,1558,4703,6261,2890,2343,3334,
2984,YFL044C,3719,2544,6263,2140,5112,1022,
2985,YPL203W,2326,3937,6263,3026,2674,3056,
2986,YBR294W,2254,4010,6264,3812,3119,3953,
2987,YPR151C,2478,3787,6265,5338,5423,2339,
2988,YCL074W,3336,2934,6270,5394,6020,5548,
2989,YJL159W,1342,4929,6271,177,92,222,
2990,YBR121C-A,4243,2033,6276,4146,2594,5059,
2991,YOL008W,4823,1453,6276,4989,3939,6070,
2992,YLR030W,3629,2648,6277,5294,5268,3757,
2993,YOR014W,2693,3592,6285,1900,1532,2306,
2994,YJR108W,2091,4195,6286,1873,4459,3779,
2995,YOL050C,4384,1902,6286,2473,1027,3760,
2996,YDR229W,3808,2483,6291,5945,5673,4575,
2997,YGR263C,4347,1944,6291,2091,3483,4498,
2998,YPL101W,3738,2555,6293,5452,5336,3560,
2999,YOR003W,3004,3289,6293,4468,3128,4881,
3000,YKR008W,2609,3686,6295,1265,934,1879,
3001,YLR437C,2701,3594,6295,6590,6564,5711,
3002,YBR205W,4881,1418,6299,1227,3914,1556,
3003,YDR531W,4611,1689,6300,2043,2299,2648,
3004,YOR161C,4285,2019,6304,4620,5260,3197,
3005,YPR024W,2869,3439,6308,1930,1809,1328,
3006,YBR243C,4233,2075,6308,3616,3810,3312,
3007,YKL018C-A,4432,1876,6308,6606,6398,6069,
3008,YOL092W,1769,4541,6310,1802,3718,4000,
3009,YOR085W,3969,2342,6311,1750,4737,1580,
3010,YIL077C,2172,4141,6313,3847,3680,2060,
3011,YPR021C,2491,3822,6313,2440,1880,3839,
3012,YDR461C-A,5507,807,6314,5960,6169,4444,
3013,YGR241C,3279,3039,6318,2957,2744,2018,
3014,YOR237W,4638,1681,6319,2944,888,1854,
3015,YIL176C,2740,3580,6320,194,798,202,
3016,YBR217W,3251,3073,6324,4116,2483,4817,
3017,YOR389W,4413,1914,6327,3721,4630,4406,
3018,YFL002W-A,1878,4449,6327,1732,1753,4063,
3019,YIL128W,3270,3057,6327,2418,1772,2696,
3020,YNL009W,3348,2980,6328,2926,1301,1816,
3021,YOL053W,2115,4215,6330,5551,5694,4967,
3022,YGL230C,2844,3488,6332,1674,758,2147,
3023,YNL102W,1435,4897,6332,1877,1325,2726,
3024,YNL148C,3460,2876,6336,6562,6515,5702,
3025,YKL100C,3651,2688,6339,1131,1691,1790,
3026,YIL043C,4721,1618,6339,2641,5740,1377,
3027,YBR012W-A,1472,4869,6341,2655,2275,3219,
3028,YMR239C,3511,2831,6342,2728,1017,1963,
3029,YAL030W,3945,2403,6348,4498,5155,5371,
3030,YPL207W,4178,2172,6350,3360,1685,3024,
3031,YPL063W,5405,946,6351,1032,907,738,
3032,YOR266W,4354,1999,6353,5185,3806,5937,
3033,YCR066W,3065,3292,6357,2187,1473,4601,
3034,YMR050C,1382,4976,6358,2454,3084,4397,
3035,YKL095W,2605,3755,6360,5229,5242,2764,
3036,YMR112C,4371,1989,6360,5853,5651,5272,
3037,YHR204W,2782,3582,6364,3856,4132,3477,
3038,YLR245C,4842,1523,6365,4795,5219,5065,
3039,YHL002C-A,3624,2743,6367,3333,4222,4868,
3040,YOR142W-A,1479,4888,6367,2659,2272,3218,
3041,YFR032C,5558,814,6372,4450,5982,1552,
3042,YNL018C,741,5632,6373,4216,5666,4446,
3043,YLR019W,3551,2822,6373,3614,4937,2578,
3044,YLR282C,1998,4377,6375,3809,6111,3989,
3045,YBR133C,1636,4740,6376,4180,5157,4901,
3046,YPL136W,3718,2659,6377,6622,6538,6089,
3047,YJR008W,3043,3337,6380,3184,3324,3461,
3048,YLR312C,1488,4894,6382,4882,4274,4300,
3049,YPR169W,3435,2950,6385,1894,2725,1618,
3050,YLR411W,3189,3199,6388,2582,2611,2957,
3051,YDL104C,2832,3559,6391,4707,3182,5219,
3052,YHR012W,3926,2469,6395,2569,1462,1724,
3053,YKL078W,2976,3422,6398,3196,3655,3928,
3054,YJR097W,3770,2631,6401,3429,3274,4678,
3055,YNL245C,4776,1626,6402,5792,5421,5229,
3056,YOL134C,4493,1910,6403,2355,1980,2554,
3057,YAL031C,1991,4413,6404,5079,4563,4166,
3058,YBL106C,2401,4006,6407,3733,3362,4185,
3059,YDR029W,2016,4393,6409,4722,5591,6405,
3060,YKL090W,1653,4760,6413,4358,4004,5110,
3061,YPL244C,4535,1878,6413,4008,4125,3390,
3062,YGR161C,2050,4368,6418,4338,5766,2889,
3063,YOR043W,2820,3603,6423,3332,2076,3098,
3064,YPR162C,3417,3008,6425,3966,3313,3204,
3065,YPR023C,2809,3618,6427,5681,5669,4854,
3066,YLR423C,3161,3266,6427,2027,1246,1778,
3067,YBR190W,3319,3109,6428,4612,5121,4733,
3068,YJL089W,1507,4922,6429,2169,1275,4975,
3069,YDR098C-A,1591,4841,6432,2822,2362,3261,
3070,YOR220W,3640,2792,6432,4880,4427,4859,
3071,YML045W-A,1702,4731,6433,2730,2346,3171,
3072,YOL104C,3450,2983,6433,3610,2630,3967,
3073,YFL019C,1162,5275,6437,1475,2258,4505,
3074,YNR052C,2512,3925,6437,5324,5640,3192,
3075,YBR141C,2569,3868,6437,5528,5824,3933,
3076,YER016W,4234,2203,6437,5808,5115,4382,
3077,YKR034W,2967,3471,6438,5687,5729,4774,
3078,YNL128W,1024,5416,6440,4571,4338,4991,
3079,YKR026C,4480,1962,6442,3828,2529,2597,
3080,YKR056W,3260,3184,6444,1379,1975,1459,
3081,YHR134W,1714,4732,6446,4549,5331,2680,
3082,YJL020W-A,1066,5391,6457,5835,5667,6463,
3083,YOR256C,2217,4241,6458,3246,1698,3561,
3084,YOR098C,2896,3564,6460,5120,2833,2700,
3085,YOL107W,3190,3272,6462,1595,1721,2400,
3086,YNL194C,2044,4419,6463,5420,5623,3936,
3087,YGL057C,2563,3904,6467,4608,4173,5413,
3088,YML045W,1698,4773,6471,2130,2857,4092,
3089,YLR251W,3442,3030,6472,1027,915,1480,
3090,YDR316W-A,1489,4984,6473,2702,2278,3168,
3091,YJL064W,2942,3532,6474,5692,5713,5157,
3092,YGL082W,4789,1685,6474,3831,3624,2214,
3093,YOR069W,4111,2365,6476,4006,3409,2530,
3094,YGR161C-C,1560,4917,6477,2699,2276,3170,
3095,YDR038C,3285,3193,6478,1331,2073,1484,
3096,YER066C-A,3081,3399,6480,1238,3703,5576,
3097,YMR052W,5312,1169,6481,5203,4032,5881,
3098,YJR015W,1908,4576,6484,4143,4849,3109,
3099,YML101C-A,4353,2131,6484,6503,6483,3552,
3100,YHL009C,3555,2930,6485,1838,1455,3404,
3101,YBR002C,3141,3345,6486,5894,5777,3343,
3102,YIL038C,2878,3610,6488,3384,1225,1973,
3103,YJR110W,3207,3281,6488,1733,1324,3129,
3104,YPR116W,4643,1848,6491,4883,4015,4889,
3105,YPL129W,4143,2351,6494,3375,2935,1831,
3106,YOR217W,2257,4237,6494,2281,1192,1954,
3107,YCR019W,3140,3356,6496,5157,5608,5494,
3108,YER159C-A,1563,4934,6497,2717,2179,3211,
3109,YCR018C-A,5834,665,6499,3658,3766,4952,
3110,YKL010C,3813,2687,6500,3011,2459,3133,
3111,YCR061W,3848,2652,6500,5913,6451,4725,
3112,YDR339C,3692,2809,6501,2684,3779,4264,
3113,YMR227C,2734,3769,6503,4599,4955,1844,
3114,YER053C-A,382,6121,6503,302,189,462,
3115,YIL130W,1812,4691,6503,2339,2307,3153,
3116,YNL286W,4523,1981,6504,5237,4829,4627,
3117,YBR041W,4752,1754,6506,950,647,1370,
3118,YPL140C,3615,2892,6507,4562,4635,3934,
3119,YDL065C,4838,1679,6517,2023,1396,1938,
3120,YOR263C,2744,3775,6519,2509,3411,4702,
3121,YOL041C,5173,1346,6519,821,428,760,
3122,YMR234W,3956,2563,6519,3157,1382,4631,
3123,YLL019C,2747,3772,6519,4731,5565,3041,
3124,YGR161C-D,1428,5094,6522,2453,2967,4318,
3125,YNL297C,2409,4115,6524,3318,2687,3984,
3126,YKL191W,4521,2003,6524,5704,5828,3516,
3127,YJR161C,3510,3015,6525,2450,3641,3459,
3128,YKL140W,3837,2690,6527,1407,1660,2724,
3129,YFR050C,3021,3509,6530,2952,2726,2896,
3130,YDR060W,4467,2066,6533,1096,1375,1247,
3131,YAR033W,3883,2651,6534,5391,5917,6145,
3132,YCL034W,4277,2260,6537,6530,6527,5725,
3133,YMR033W,4181,2357,6538,1643,898,2007,
3134,YOL128C,1894,4644,6538,5466,5008,5516,
3135,YNR002C,2119,4420,6539,3722,5688,2208,
3136,YCR046C,3673,2868,6541,6439,6626,2864,
3137,YPR158W-A,1589,4953,6542,2657,2273,3216,
3138,YFL047W,3389,3154,6543,3824,4000,3198,
3139,YJR160C,2933,3611,6544,3695,2878,3364,
3140,YOR020W-A,3327,3220,6547,3711,2003,2200,
3141,YHR153C,2399,4150,6549,5148,4613,4173,
3142,YKL065W-A,2884,3665,6549,1676,605,2796,
3143,YGL024W,3431,3119,6550,5145,5757,2450,
3144,YPL119C,2766,3785,6551,4868,4097,2466,
3145,YDR098C-B,1368,5184,6552,2166,2876,4020,
3146,YPL135W,4855,1698,6553,4212,4788,1337,
3147,YHL042W,3502,3053,6555,1692,3567,2373,
3148,YNL223W,2149,4406,6555,4982,3171,5251,
3149,YOL103W-A,2278,4278,6556,2912,2446,3215,
3150,YMR270C,1699,4858,6557,4075,4761,3631,
3151,YCR087C-A,5806,755,6561,6126,6198,1779,
3152,YNL034W,902,5661,6563,4965,5893,4708,
3153,YKR028W,3618,2946,6564,2121,1970,2522,
3154,YPL060C-A,2322,4243,6565,1376,652,2255,
3155,YMR130W,3949,2617,6566,3529,3280,3155,
3156,YKR068C,4859,1710,6569,4652,4077,2903,
3157,YER144C,2216,4353,6569,4624,4752,5563,
3158,YDR210C-D,1470,5100,6570,2110,2743,4041,
3159,YDL165W,5127,1443,6570,4044,4733,4216,
3160,YHR175W,3805,2767,6572,2621,4098,5133,
3161,YML013W,4316,2257,6573,5084,5809,2519,
3162,YLR296W,2628,3945,6573,5455,4949,5852,
3163,YDR542W,2852,3721,6573,224,1001,216,
3164,YNL054W-B,1877,4698,6575,2385,2951,4422,
3165,YOR144C,1119,5460,6579,3359,3223,3859,
3166,YKL068W-A,3803,2776,6579,3534,2120,4717,
3167,YMR031C,4874,1706,6580,2371,2018,958,
3168,YGR149W,2705,3877,6582,1890,2747,3863,
3169,YIL055C,1970,4613,6583,5470,4841,5489,
3170,YER050C,1695,4890,6585,3884,4304,3376,
3171,YBR144C,2193,4392,6585,4052,5003,3999,
3172,YBR271W,2180,4407,6587,5798,5126,5612,
3173,YMR148W,5420,1171,6591,4346,5428,3307,
3174,YKL129C,3007,3587,6594,2933,1951,2072,
3175,YPL073C,4180,2415,6595,4831,4570,6235,
3176,YNR033W,4023,2575,6598,3892,4867,3571,
3177,YLR258W,4377,2224,6601,2225,2385,1570,
3178,YKL054C,5646,955,6601,635,186,830,
3179,YGR007W,3911,2692,6603,3361,3351,2776,
3180,YHR214C-C,1622,4981,6603,2742,2240,3255,
3181,YMR224C,2374,4231,6605,3324,2838,4583,
3182,YDR316W-B,1474,5132,6606,2149,2815,4129,
3183,YGR038C-B,1420,5186,6606,2237,2949,4126,
3184,YOR142W-B,1373,5233,6606,2420,3008,4410,
3185,YNL243W,4914,1693,6607,5518,5553,2047,
3186,YEL076C-A,2883,3725,6608,6190,6305,6273,
3187,YHR077C,2405,4203,6608,2618,2370,2662,
3188,YKR069W,3305,3304,6609,5235,4704,3612,
3189,YGL251C,2292,4318,6610,4484,2511,4767,
3190,YGR040W,3116,3495,6611,3783,4460,4050,
3191,YOL125W,4051,2562,6613,5696,5262,4008,
3192,YLR046C,2550,4064,6614,5348,5161,5485,
3193,YLR070C,3438,3177,6615,6062,5922,5458,
3194,YDR384C,5038,1577,6615,5560,5852,3436,
3195,YOR357C,5149,1469,6618,4817,5347,4024,
3196,YDR294C,3786,2834,6620,1984,2683,1940,
3197,YJR107W,3697,2923,6620,3704,3017,4167,
3198,YGR128C,3325,3296,6621,1529,1150,2136,
3199,YDR534C,1352,5269,6621,831,946,503,
3200,YDR057W,4257,2366,6623,4022,3019,3523,
3201,YER105C,3361,3262,6623,3314,2707,3753,
3202,YFL027C,3547,3077,6624,4461,4172,4347,
3203,YDL098C,3591,3035,6626,5140,4243,2463,
3204,YJR114W,1804,4824,6628,6166,6417,5908,
3205,YHR036W,2097,4533,6630,4364,4285,4253,
3206,YER038W-A,2269,4363,6632,3156,5468,2518,
3207,YNL225C,2068,4566,6634,3326,1428,3372,
3208,YDR358W,1815,4819,6634,3861,3391,3169,
3209,YKL173W,2575,4059,6634,4225,3506,3501,
3210,YMR071C,5329,1306,6635,5371,5481,5633,
3211,YJL160C,2929,3710,6639,4387,3023,3142,
3212,YDR210C-C,1535,5105,6640,2711,2447,3174,
3213,YPR059C,4270,2371,6641,3554,1210,4120,
3214,YIL153W,2356,4285,6641,6542,6525,5777,
3215,YIL095W,2460,4182,6642,2799,1414,3358,
3216,YLR165C,3138,3510,6648,2115,2350,2195,
3217,YIL135C,2807,3841,6648,5158,5422,4113,
3218,YOL103W-B,2264,4386,6650,2260,2987,4254,
3219,YBR059C,4121,2530,6651,3177,2504,2512,
3220,YBR124W,3505,3146,6651,5825,5543,4682,
3221,YLR464W,2828,3824,6652,6192,6303,6272,
3222,YDR054C,3734,2920,6654,1359,4033,2120,
3223,YGR013W,4240,2420,6660,5024,5525,2325,
3224,YNL023C,2714,3948,6662,4435,3086,5085,
3225,YIL098C,4293,2369,6662,4525,5617,1516,
3226,YDR296W,3665,2999,6664,6139,6271,4111,
3227,YBR214W,5290,1377,6667,4723,5366,2671,
3228,YDR142C,3055,3614,6669,4587,3298,5680,
3229,YOL048C,2783,3886,6669,3905,3606,4657,
3230,YOL026C,3796,2874,6670,6605,6608,5475,
3231,YPL053C,4179,2491,6670,1659,876,1852,
3232,YCL032W,4042,2629,6671,5164,5555,4051,
3233,YOR175C,3896,2775,6671,770,574,1446,
3234,YOR094W,5421,1251,6672,4080,2335,2669,
3235,YPL196W,3722,2951,6673,4405,3011,4537,
3236,YLL060C,4762,1912,6674,6315,6281,5853,
3237,YJL146W,2917,3763,6680,5339,4396,5366,
3238,YMR034C,2954,3728,6682,4794,3186,4039,
3239,YGL119W,3455,3227,6682,4235,1482,2772,
3240,YJL070C,2968,3716,6684,2946,1908,3965,
3241,YLR379W,4614,2070,6684,6221,6331,5305,
3242,YBR301W,2776,3911,6687,191,861,209,
3243,YBR223C,3276,3412,6688,5833,5811,5467,
3244,YIL104C,3198,3491,6689,3714,3829,2906,
3245,YLR319C,3208,3481,6689,3955,2749,2608,
3246,YHR022C,4852,1839,6691,4021,4293,3327,
3247,YML043C,1332,5360,6692,2019,1497,2085,
3248,YPR089W,3844,2850,6694,1355,1547,2110,
3249,YMR076C,2970,3724,6694,1748,1237,2321,
3250,YPR188C,5110,1585,6695,4369,4549,3102,
3251,YOL086W-A,4469,2227,6696,5045,5855,3496,
3252,YER172C,3076,3623,6699,3365,1844,3406,
3253,YDR167W,2816,3883,6699,6168,5674,5661,
3254,YLR326W,4679,2021,6700,5356,3975,4132,
3255,YJR126C,1545,5156,6701,4149,4219,4640,
3256,YLR164W,2962,3740,6702,5383,4824,4632,
3257,YML071C,3965,2740,6705,3092,3633,1761,
3258,YDR173C,2348,4358,6706,5161,4223,5652,
3259,YPL108W,2187,4522,6709,5957,5934,5438,
3260,YJL196C,2666,4043,6709,3179,3057,3314,
3261,YPL083C,2276,4436,6712,4511,2810,4814,
3262,YAL040C,1105,5608,6713,1217,3355,1783,
3263,YLR199C,2895,3818,6713,4847,3262,5117,
3264,YIL029W-A,2839,3875,6714,6219,4972,6123,
3265,YKR033C,4582,2133,6715,6079,6106,5374,
3266,YAL014C,4570,2149,6719,6471,6314,4758,
3267,YER160C,1516,5206,6722,2631,3094,4677,
3268,YPR158W-B,1510,5214,6724,2144,2799,4135,
3269,YHR139C,4600,2125,6725,1605,2501,2385,
3270,YER024W,5338,1387,6725,3304,3781,2410,
3271,YOR002W,4131,2595,6726,4396,3581,5391,
3272,YDR336W,2514,4214,6728,3460,3340,4143,
3273,YNL190W,523,6206,6729,167,831,246,
3274,YKL112W,3289,3440,6729,1305,3208,1824,
3275,YGR261C,3049,3681,6730,2399,1441,2448,
3276,YHL049C,3226,3505,6731,5304,5871,3754,
3277,YBR016W,3699,3032,6731,6305,6179,3771,
3278,YBR001C,2767,3965,6732,4280,2183,3506,
3279,YPL215W,1732,5001,6733,3827,1343,3897,
3280,YNL270C,2157,4577,6734,5539,5604,3491,
3281,YDL025W-A,3240,3496,6736,738,6004,3150,
3282,YJR122W,3299,3438,6737,3043,2235,3668,
3283,YBR260C,4540,2198,6738,2277,2809,1966,
3284,YDL006W,4145,2594,6739,3982,1719,4669,
3285,YHR098C,3620,3120,6740,1579,1764,2682,
3286,YKL051W,2393,4347,6740,2593,4268,3452,
3287,YHL031C,4836,1907,6743,5900,6472,3481,
3288,YIR002C,1610,5136,6746,2280,2242,2763,
3289,YMR075C-A,4583,2163,6746,2154,1564,4152,
3290,YJL176C,3623,3124,6747,3186,2969,1704,
3291,YMR244W,3917,2832,6749,3725,5290,3051,
3292,YOR141C,3545,3211,6756,2495,2745,2387,
3293,YBR045C,1912,4844,6756,3252,1424,3971,
3294,YPL107W,3666,3092,6758,3178,2622,2134,
3295,YMR122C,3432,3327,6759,6596,6607,4801,
3296,YPL138C,3221,3541,6762,3656,3337,4905,
3297,YHR206W,3690,3072,6762,3115,4018,3379,
3298,YNL212W,4471,2292,6763,1814,1203,1829,
3299,YGR022C,4276,2487,6763,6293,6360,5951,
3300,YDR505C,3158,3607,6765,1957,1928,2222,
3301,YNL172W,2124,4643,6767,4542,3730,4726,
3302,YHR214C-B,1449,5321,6770,2433,3015,4565,
3303,YNL267W,3519,3256,6775,2596,2040,2603,
3304,YBR012W-B,1707,5070,6777,2564,3103,4665,
3305,YNL277W,4032,2745,6777,5243,5240,2168,
3306,YPL116W,2089,4695,6784,2271,1211,2509,
3307,YLR188W,3535,3252,6787,5200,4866,4268,
3308,YPL161C,3249,3538,6787,4820,4016,4890,
3309,YDR406W,4068,2723,6791,1461,1662,1805,
3310,YKR078W,2455,4338,6793,2540,3417,3399,
3311,YGL005C,3012,3782,6794,4738,1407,3483,
3312,YNL109W,2493,4304,6797,5431,5259,5905,
3313,YHR127W,4440,2360,6800,5043,5180,2590,
3314,YLR462W,3823,2979,6802,5197,5826,2836,
3315,YNR032W,3641,3161,6802,4656,5223,3742,
3316,YOR077W,3143,3660,6803,5783,6167,4713,
3317,YPR180W,4464,2341,6805,2610,1723,2166,
3318,YKL092C,2893,3919,6812,2821,1977,3710,
3319,YBL020W,4524,2290,6814,3941,4818,2478,
3320,YER186C,2467,4352,6819,5653,5229,5942,
3321,YNR012W,4075,2744,6819,1556,1451,2783,
3322,YNL305C,4324,2496,6820,6313,6438,5735,
3323,YDR175C,1821,4999,6820,3784,2577,3038,
3324,YGL081W,2588,4234,6822,3237,3786,3764,
3325,YLR408C,2010,4814,6824,3663,5255,6144,
3326,YNL222W,2947,3878,6825,1614,615,3701,
3327,YGR193C,5233,1592,6825,2811,2136,1517,
3328,YFR021W,3947,2878,6825,4708,5490,3562,
3329,YOR273C,3916,2910,6826,1591,2209,1520,
3330,YER064C,1476,5351,6827,4421,3771,3588,
3331,YDR123C,1831,4997,6828,4872,5508,5349,
3332,YGR074W,4304,2525,6829,4648,5000,4755,
3333,YPL228W,3397,3432,6829,1961,1155,2115,
3334,YGR156W,2342,4488,6830,4203,3604,4107,
3335,YBR087W,4133,2701,6834,2673,2027,3663,
3336,YLR343W,2713,4123,6836,3199,1699,3400,
3337,YJL062W-A,4112,2725,6837,6455,6586,2875,
3338,YGR025W,3390,3451,6841,4870,2110,2170,
3339,YKL023W,4128,2721,6849,6008,5961,3093,
3340,YPR107C,1685,5164,6849,1939,2330,5819,
3341,YGR035C,3708,3141,6849,2194,3416,5084,
3342,YOR012W,2251,4598,6849,5234,5350,5389,
3343,YPR056W,2937,3912,6849,4510,2064,3139,
3344,YPL213W,3784,3066,6850,5204,4648,4816,
3345,YPL208W,4449,2401,6850,3418,3645,3847,
3346,YMR091C,3313,3537,6850,3431,2566,2199,
3347,YBR216C,3773,3078,6851,3020,2150,4182,
3348,YDR462W,2335,4517,6852,6290,6356,5583,
3349,YNR068C,1419,5440,6859,3584,2986,4926,
3350,YLR410W-B,2316,4546,6862,1642,1631,4033,
3351,YOR016C,5271,1593,6864,1307,2445,1643,
3352,YCR086W,4346,2519,6865,6546,6471,5596,
3353,YGL205W,4196,2671,6867,2160,2250,1748,
3354,YOR090C,4229,2644,6873,3811,3240,2357,
3355,YNR024W,4081,2794,6875,3795,4584,4312,
3356,YOR360C,3167,3709,6876,1611,1227,4087,
3357,YJR155W,4456,2423,6879,3099,3953,1987,
3358,YIL139C,3753,3128,6881,1533,1015,1897,
3359,YER159C,4461,2421,6882,6174,5691,3702,
3360,YPR152C,3412,3470,6882,6101,6361,4235,
3361,YGL227W,2909,3974,6883,1299,1156,1787,
3362,YJR055W,3409,3474,6883,3768,1056,5422,
3363,YLR398C,3126,3758,6884,1644,1136,1099,
3364,YJR094C,2051,4834,6885,868,502,2394,
3365,YHR167W,2639,4247,6886,4751,4115,5319,
3366,YCL019W,2240,4647,6887,1725,1776,4023,
3367,YJL019W,3437,3452,6889,4726,4936,3165,
3368,YPR061C,1792,5098,6890,2455,3234,2196,
3369,YGR100W,3215,3676,6891,3438,2213,3084,
3370,YNL191W,4711,2180,6891,2775,3899,2059,
3371,YAL045C,4636,2261,6897,5705,6390,6096,
3372,YLR128W,1566,5331,6897,5349,5833,4978,
3373,YER188W,4306,2593,6899,3652,4391,3069,
3374,YMR029C,2818,4082,6900,2652,2557,2150,
3375,YCL058W-A,4146,2755,6901,6267,6189,2921,
3376,YJR028W,2347,4554,6901,2860,2256,3186,
3377,YOR202W,4290,2622,6912,6447,6400,5706,
3378,YNR003C,4694,2218,6912,3480,4221,1624,
3379,YLR204W,3709,3205,6914,6418,5689,4335,
3380,YER119C-A,3601,3315,6916,6119,5813,5906,
3381,YNL249C,3287,3629,6916,2353,1891,4757,
3382,YKL138C-A,3233,3683,6916,5585,4057,5785,
3383,YHL021C,4465,2452,6917,2770,3825,2539,
3384,YHR032W,2495,4422,6917,5973,6207,4083,
3385,YPL070W,3106,3812,6918,2497,1752,3685,
3386,YOL014W,2420,4498,6918,4321,1096,5637,
3387,YHR152W,2658,4263,6921,5580,5821,3570,
3388,YHR070C-A,2602,4320,6922,6559,6644,6216,
3389,YKR072C,3964,2958,6922,2839,4895,1923,
3390,YHL009W-B,2581,4342,6923,1380,700,2359,
3391,YLR016C,4210,2713,6923,5353,5906,4916,
3392,YGL233W,3611,3313,6924,1560,872,1924,
3393,YJR129C,4038,2886,6924,5951,6082,4017,
3394,YML031W,4616,2308,6924,5482,5670,4896,
3395,YLR011W,4693,2233,6926,6440,5873,6138,
3396,YLR215C,3643,3283,6926,3255,3394,2958,
3397,YMR122W-A,1539,5390,6929,397,2510,434,
3398,YJL201W,1949,4988,6937,2430,2198,3190,
3399,YML117W,2386,4551,6937,3583,3413,3163,
3400,YPR034W,4736,2202,6938,5731,5802,2350,
3401,YNL118C,2301,4639,6940,3242,1823,3294,
3402,YLR147C,5496,1446,6942,6288,5373,5122,
3403,YML061C,3054,3889,6943,3477,3430,2899,
3404,YGL228W,5142,1802,6944,2475,4384,1245,
3405,YDR031W,4221,2724,6945,3122,1334,2616,
3406,YDR122W,2780,4170,6950,4490,3997,3924,
3407,YGL164C,3923,3027,6950,5252,5047,3091,
3408,YFR046C,3088,3863,6951,5685,5536,4058,
3409,YHR028C,5083,1869,6952,2760,3109,3212,
3410,YLR110C,3291,3661,6952,26,109,104,
3411,YNL252C,3843,3111,6954,4772,2721,3082,
3412,YHL044W,2077,4878,6955,2059,2727,2628,
3413,YNL284C-A,2287,4672,6959,2532,1916,2768,
3414,YDL227C,1344,5620,6964,4650,4053,4619,
3415,YDR318W,4199,2768,6967,3001,2555,4573,
3416,YDR325W,1751,5218,6969,3455,2695,2489,
3417,YGR197C,4205,2764,6969,4418,4552,3288,
3418,YGR294W,2890,4084,6974,201,714,207,
3419,YJL038C,3942,3033,6975,5857,4426,5277,
3420,YBR237W,2417,4560,6977,4388,3797,2822,
3421,YML005W,4108,2873,6981,3942,3937,5346,
3422,YPR147C,4935,2047,6982,3488,2168,3535,
3423,YAR030C,4163,2820,6983,4915,5497,6288,
3424,YNL234W,2646,4337,6983,3146,3012,4053,
3425,YGL129C,4142,2841,6983,2779,2290,2064,
3426,YGR017W,4818,2166,6984,1620,3217,1521,
3427,YPR170W-B,6303,681,6984,3288,4728,4876,
3428,YDR410C,4102,2883,6985,4528,4627,5775,
3429,YML118W,3290,3697,6987,5273,4786,3248,
3430,YMR325W,3741,3246,6987,175,166,184,
3431,YLR418C,4519,2473,6992,3593,2552,3183,
3432,YNL201C,1713,5279,6992,2697,3269,3490,
3433,YGR066C,5135,1857,6992,3459,3069,4035,
3434,YNL054W-A,2319,4674,6993,2877,2358,3121,
3435,YBL034C,3228,3766,6994,2048,2208,2604,
3436,YGL035C,3474,3521,6995,3249,3617,4439,
3437,YDR143C,2338,4658,6996,2910,3880,3649,
3438,YIL132C,3581,3418,6999,4400,5044,3751,
3439,YBL086C,2836,4164,7000,5223,4574,3886,
3440,YCR052W,3634,3367,7001,5538,5905,3298,
3441,YLR146C,5921,1082,7003,1264,2192,1590,
3442,YMR268C,2715,4291,7006,4242,3945,5244,
3443,YPR139C,5088,1919,7007,4182,4986,2250,
3444,YKR040C,3715,3294,7009,3109,5581,5399,
3445,YHR193C-A,4022,2988,7010,6324,6366,6284,
3446,YKL141W,4805,2207,7012,1125,1944,1390,
3447,YLR257W,4415,2599,7014,4308,4538,1909,
3448,YDR266C,3220,3796,7016,1752,1967,3646,
3449,YPR185W,3749,3268,7017,3888,3892,4810,
3450,YOR274W,2450,4568,7018,3214,3919,2552,
3451,YCR068W,4506,2514,7020,5639,6034,3625,
3452,YNL115C,4837,2183,7020,2819,4014,2249,
3453,YNL182C,4977,2044,7021,2236,1738,2582,
3454,YDL024C,2295,4729,7024,4748,3635,4721,
3455,YDR522C,1689,5337,7026,1717,1112,1693,
3456,YGR052W,2702,4324,7026,1672,3237,2061,
3457,YPL170W,3867,3160,7027,6096,5579,3761,
3458,YLR375W,4909,2118,7027,5823,5953,4540,
3459,YMR135W-A,1946,5082,7028,6157,6364,5471,
3460,YGL108C,5732,1297,7029,5796,5117,1767,
3461,YNL291C,1458,5571,7029,3274,2724,4503,
3462,YER076C,4581,2449,7030,3510,4755,3438,
3463,YDR507C,4104,2927,7031,2737,2033,1702,
3464,YDR008C,3541,3492,7033,4174,2801,5168,
3465,YFR026C,5684,1351,7035,6003,5560,5378,
3466,YGR038W,5203,1832,7035,1830,1653,3316,
3467,YJL200C,5317,1720,7037,774,496,913,
3468,YGR280C,3834,3204,7038,4623,5650,1813,
3469,YGR081C,5047,1992,7039,1424,2277,949,
3470,YML037C,3135,3905,7040,3631,3026,2735,
3471,YBL080C,2583,4457,7040,4952,5293,3193,
3472,YBR057C,3196,3844,7040,4251,1904,2797,
3473,YDR493W,4568,2474,7042,5925,5166,4942,
3474,YBL008W,2101,4941,7042,3995,2922,3829,
3475,YER083C,3912,3131,7043,5914,5935,4559,
3476,YLR320W,2067,4977,7044,3568,3482,4629,
3477,YKL197C,3771,3274,7045,4452,3854,3734,
3478,YBR302C,3889,3156,7045,2691,3782,4195,
3479,YDL019C,4749,2299,7048,3334,2717,2143,
3480,YDR045C,4422,2627,7049,1948,1147,5934,
3481,YPL104W,3418,3633,7051,3565,3020,2585,
3482,YDL072C,4107,2945,7052,2323,5271,1389,
3483,YOL043C,4322,2736,7058,4638,3984,3672,
3484,YMR311C,4066,2994,7060,5610,5477,2470,
3485,YIL066W-A,3490,3571,7061,5039,5780,6074,
3486,YHR147C,4313,2750,7063,4100,3024,3037,
3487,YIL163C,1281,5783,7064,5314,5957,5579,
3488,YHR105W,3858,3215,7073,5948,6287,6483,
3489,YNL284C-B,2265,4808,7073,2411,2965,4532,
3490,YPL252C,4024,3050,7074,5788,6177,3022,
3491,YDR458C,2528,4549,7077,3996,1447,4095,
3492,YKL137W,4700,2379,7079,4815,2107,4944,
3493,YGR220C,5002,2080,7082,1999,1058,2291,
3494,YDR362C,3050,4032,7082,5176,3805,4131,
3495,YKL224C,4004,3079,7083,184,221,217,
3496,YKL110C,4103,2981,7084,3572,5343,4737,
3497,YIR028W,3676,3411,7087,1662,1584,2635,
3498,YGR117C,5011,2077,7088,2634,2762,4662,
3499,YBR126W-A,4917,2171,7088,4944,6344,1096,
3500,YHR148W,3877,3212,7089,1787,4152,2057,
3501,YLR015W,2500,4592,7092,4363,4265,3796,
3502,YML057C-A,3979,3113,7092,6445,5841,6021,
3503,YPL265W,3727,3365,7092,758,1195,1314,
3504,YJR062C,3265,3827,7092,3924,2592,3815,
3505,YMR157C,4386,2707,7093,2679,3249,3409,
3506,YLR077W,3267,3826,7093,4268,4093,2936,
3507,YLR133W,2926,4177,7103,2872,4155,2009,
3508,YDL102W,3354,3751,7105,1458,1316,1878,
3509,YDR409W,3147,3959,7106,4572,3744,5482,
3510,YNL041C,3406,3701,7107,2642,1850,2477,
3511,YGR216C,1104,6007,7111,4133,2598,5574,
3512,YKR027W,2648,4465,7113,4177,4286,5163,
3513,YJR075W,4151,2963,7114,1704,3721,1526,
3514,YBR069C,4474,2647,7121,3006,3799,3059,
3515,YKL187C,3368,3753,7121,5451,5361,3420,
3516,YOR068C,4115,3006,7121,5668,3929,4732,
3517,YNL313C,4773,2352,7125,2127,1141,2386,
3518,YGR121W-A,3089,4037,7126,3841,3279,5211,
3519,YDR333C,3941,3187,7128,2014,1431,2113,
3520,YDR034C-D,3098,4030,7128,1623,1568,3976,
3521,YKL206C,5090,2040,7130,5869,5868,5915,
3522,YNL263C,5295,1838,7133,2817,5138,2686,
3523,YER176W,4890,2246,7136,4248,4689,2521,
3524,YNL330C,3973,3163,7136,2834,1964,2912,
3525,YBL061C,2959,4180,7139,4995,2186,3811,
3526,YEL044W,4425,2719,7144,6369,6478,4269,
3527,YGR196C,1924,5227,7151,4117,3095,3602,
3528,YOR385W,2659,4492,7151,2299,3159,5504,
3529,YLR346C,3469,3682,7151,3737,1783,3692,
3530,YDL011C,4703,2448,7151,3506,3590,3888,
3531,YKL177W,3627,3527,7154,2585,1632,3755,
3532,YLR106C,3529,3626,7155,1856,2096,2019,
3533,YER068W,2677,4479,7156,2335,2154,2465,
3534,YDR246W,4544,2615,7159,4270,5901,4093,
3535,YDR288W,3315,3845,7160,3403,3396,2963,
3536,YER037W,4672,2489,7161,2362,3780,2098,
3537,YCL016C,4172,2991,7163,5643,5898,3494,
3538,YLL030C,3810,3354,7164,3098,2444,4989,
3539,YOL110W,2158,5007,7165,6674,6675,6604,
3540,YIR041W,3744,3421,7165,160,80,192,
3541,YLR302C,2070,5097,7167,4444,4741,6296,
3542,YKL006C-A,4537,2638,7175,5331,5108,6009,
3543,YBR174C,3045,4132,7177,5361,3998,5077,
3544,YPR001W,2731,4447,7178,5325,4357,4638,
3545,YDR430C,3477,3705,7182,2424,2197,2388,
3546,YBR072C-A,5686,1497,7183,4365,5419,6239,
3547,YCR065W,1980,5204,7184,3836,4734,3497,
3548,YDL009C,4725,2459,7184,1314,4490,4974,
3549,YKL087C,2700,4484,7184,4529,5084,2862,
3550,YKL170W,3661,3524,7185,3773,4030,2228,
3551,YGL259W,3206,3980,7186,4892,4430,5436,
3552,YMR117C,2939,4248,7187,2589,3379,3156,
3553,YJL215C,4763,2426,7189,6125,6321,5994,
3554,YDL248W,3717,3473,7190,2172,3405,3311,
3555,YFL046W,3242,3950,7192,4666,2945,3301,
3556,YGR097W,3876,3316,7192,3101,2999,2962,
3557,YGL219C,2363,4830,7193,5114,5390,4822,
3558,YOR358W,3909,3284,7193,6071,6038,3433,
3559,YBL100W-B,2446,4748,7194,1728,1688,4100,
3560,YBR203W,1303,5891,7194,1971,2653,2184,
3561,YML132W,3955,3241,7196,2690,3787,4196,
3562,YOL101C,3645,3553,7198,4309,3149,4886,
3563,YER017C,3668,3534,7202,4316,4780,2623,
3564,YPL039W,1531,5671,7202,5379,5316,5199,
3565,YJR041C,3434,3768,7202,2609,2129,3424,
3566,YMR086W,4733,2471,7204,5162,4301,4049,
3567,YHL030W-A,4510,2695,7205,5929,6192,5393,
3568,YPL227C,5734,1471,7205,920,704,1129,
3569,YGR044C,3476,3730,7206,5964,5514,5425,
3570,YNL310C,4635,2572,7207,4971,5874,3556,
3571,YDR010C,4396,2812,7208,6244,6566,5363,
3572,YJL076W,4885,2323,7208,3119,2753,2149,
3573,YPL071C,5194,2014,7208,1944,1922,2446,
3574,YNL324W,3170,4040,7210,4619,4364,6311,
3575,YDL086C-A,4184,3029,7213,6187,6064,4517,
3576,YAL002W,3377,3837,7214,3204,2914,3637,
3577,YKL059C,3168,4050,7218,3016,3321,2591,
3578,YOR019W,2448,4772,7220,2712,2613,3304,
3579,YMR218C,2580,4640,7220,3596,2974,3416,
3580,YJL042W,3828,3393,7221,4005,5420,2712,
3581,YDR514C,3314,3907,7221,5268,4386,4112,
3582,YNL021W,3306,3915,7221,1882,1540,2645,
3583,YKL179C,4512,2710,7222,4701,2956,2609,
3584,YKL174C,3166,4057,7223,4592,4056,4987,
3585,YIL085C,4156,3070,7226,1453,2491,2831,
3586,YDR376W,3486,3741,7227,2241,3420,3164,
3587,YML075C,4759,2472,7231,1075,1140,1371,
3588,YBR272C,4892,2339,7231,3440,2991,4315,
3589,YPL185W,2785,4448,7233,2378,3840,5642,
3590,YKL205W,3687,3546,7233,1539,1419,2469,
3591,YLL047W,2247,4987,7234,1338,3494,5003,
3592,YER119C,5077,2157,7234,6191,6268,5195,
3593,YDR303C,4263,2972,7235,1850,1437,2290,
3594,YDL094C,3296,3940,7236,4520,4960,4124,
3595,YHL046W-A,4098,3138,7236,4563,3827,5860,
3596,YOR013W,4298,2938,7236,6052,6041,4953,
3597,YAL047W-A,3496,3742,7238,2479,1665,5523,
3598,YOR040W,4296,2943,7239,3659,4073,2880,
3599,YHR017W,2081,5159,7240,4688,4766,5035,
3600,YOL002C,3346,3895,7241,4130,3664,5164,
3601,YOR378W,2803,4438,7241,5588,5165,5651,
3602,YBR119W,4242,3000,7242,5388,5071,4365,
3603,YMR133W,3159,4085,7244,3533,3843,3137,
3604,YGR010W,4139,3106,7245,3117,3978,3787,
3605,YDR096W,2645,4602,7247,1837,1784,3914,
3606,YER127W,4969,2280,7249,3961,4657,1363,
3607,YIL175W,1921,5330,7251,1288,3238,5271,
3608,YHL007C,4321,2935,7256,2971,2788,2322,
3609,YAL017W,3430,3828,7258,4376,3625,3585,
3610,YNL072W,3121,4139,7260,6069,6320,4163,
3611,YER020W,3539,3722,7261,6326,6343,3385,
3612,YKL002W,4922,2345,7267,5134,4422,3495,
3613,YOR264W,1648,5619,7267,3882,3242,3068,
3614,YNL336W,3894,3375,7269,2778,4083,4077,
3615,YBR038W,4247,3025,7272,1744,1988,1930,
3616,YHL016C,2076,5196,7272,2055,1167,2504,
3617,YDR180W,3471,3808,7279,2547,2388,3196,
3618,YOR132W,4001,3278,7279,4175,4601,3948,
3619,YDR494W,3920,3360,7280,3971,2022,2361,
3620,YNR076W,2751,4530,7281,173,719,177,
3621,YIL099W,4005,3276,7281,5880,6252,3833,
3622,YHR188C,3444,3838,7282,4767,5184,3181,
3623,YHR155W,2378,4906,7284,2537,2153,3729,
3624,YBR040W,5015,2271,7286,2376,1300,3391,
3625,YFR005C,4020,3270,7290,4148,3614,4684,
3626,YOL130W,4790,2501,7291,3342,2863,3199,
3627,YGR252W,2632,4660,7292,4908,3742,4002,
3628,YER053C,4653,2639,7292,1800,1123,2128,
3629,YAL041W,2008,5284,7292,4275,4715,4654,
3630,YLL021W,5106,2186,7292,3772,3281,1921,
3631,YGR109W-A,2555,4738,7293,1358,3497,3455,
3632,YJR135C,2164,5130,7294,4735,4522,5556,
3633,YDR375C,4044,3251,7295,2554,3956,2069,
3634,YJL025W,2611,4684,7295,5076,5519,5074,
3635,YAL056W,2127,5169,7296,4655,4322,5695,
3636,YDR310C,3630,3667,7297,4352,4447,3120,
3637,YCL001W-A,3129,4168,7297,1211,614,1383,
3638,YDL076C,4254,3044,7298,4491,3944,4869,
3639,YCL031C,3856,3443,7299,1914,1435,1712,
3640,YMR111C,3127,4172,7299,4946,4853,4401,
3641,YDR107C,3250,4049,7299,3691,2925,4613,
3642,YDR264C,4284,3017,7301,3734,3463,4918,
3643,YGL083W,4395,2906,7301,1958,1921,2651,
3644,YKL070W,2623,4679,7302,4953,4481,3837,
3645,YML038C,3385,3918,7303,4036,4087,4443,
3646,YKL218C,5609,1695,7304,6154,5445,5568,
3647,YMR023C,3388,3917,7305,4590,4441,4731,
3648,YOL033W,3904,3403,7307,3909,3877,4569,
3649,YEL041W,1765,5543,7308,4920,4143,4062,
3650,YAL034C,2504,4805,7309,5216,5337,3166,
3651,YNL253W,3647,3664,7311,1932,1525,3350,
3652,YDR146C,3872,3441,7313,2705,2047,3534,
3653,YGL051W,4829,2485,7314,5676,6084,6305,
3654,YNL169C,4452,2864,7316,3166,3543,3285,
3655,YLR461W,3177,4145,7322,178,533,187,
3656,YOR131C,4479,2846,7325,5755,4423,3712,
3657,YAR019C,2489,4836,7325,3863,5281,3963,
3658,YGR071C,2886,4441,7327,3297,3091,4546,
3659,YJL147C,4220,3108,7328,4282,4513,4650,
3660,YGR053C,2800,4528,7328,3579,2736,4652,
3661,YER184C,3635,3694,7329,4045,4178,4570,
3662,YER180C,2640,4689,7329,4114,4877,3689,
3663,YKL165C,4530,2800,7330,1370,1122,2544,
3664,YLR389C,5200,2130,7330,2085,3009,1999,
3665,YEL023C,2773,4561,7334,3066,1488,4475,
3666,YGR223C,4375,2961,7336,5177,5028,4294,
3667,YPL222W,4919,2417,7336,5952,6053,3791,
3668,YBR264C,5685,1653,7338,6553,6230,6168,
3669,YNL240C,3042,4297,7339,6597,6627,6140,
3670,YMR172C-A,3345,3994,7339,1993,5007,5904,
3671,YAL013W,2005,5341,7346,6519,6620,4818,
3672,YKL131W,3599,3759,7358,4343,5389,5952,
3673,YBR050C,2003,5356,7359,3268,4880,4561,
3674,YNR075W,3399,3961,7360,3952,3446,4407,
3675,YNR022C,4578,2788,7366,4031,5378,2094,
3676,YGL203C,2874,4493,7367,2502,3140,1880,
3677,YBL060W,3779,3591,7370,2531,3493,3115,
3678,YDR094W,4086,3285,7371,6258,6395,6139,
3679,YLR173W,2591,4782,7373,5553,5857,5465,
3680,YDR046C,4325,3048,7373,2068,3322,1770,
3681,YNL086W,3366,4007,7373,6407,6560,6055,
3682,YMR264W,5136,2238,7374,5508,5002,2819,
3683,YDR470C,3977,3398,7375,2156,2822,2084,
3684,YIL028W,4587,2789,7376,4507,4620,4392,
3685,YOL004W,4258,3118,7376,3205,2682,2392,
3686,YJL135W,4702,2674,7376,2377,3672,3690,
3687,YGR058W,3766,3612,7378,4716,4183,4604,
3688,YLR082C,2881,4501,7382,3277,3136,4612,
3689,YPR057W,3518,3869,7387,5863,5414,4971,
3690,YNR056C,2826,4562,7388,2507,3973,3374,
3691,YLR166C,3113,4275,7388,1657,782,1340,
3692,YGR108W,2760,4629,7389,3160,3496,2589,
3693,YBL097W,2649,4742,7391,2605,2449,2445,
3694,YOR081C,4018,3374,7392,3523,5471,3426,
3695,YGR027W-A,2436,4957,7393,2990,2453,3257,
3696,YFL031W,4397,2996,7393,6359,6293,5561,
3697,YGL209W,1329,6065,7394,4536,4726,4199,
3698,YCL048W,3933,3461,7394,2012,2214,2103,
3699,YML039W,2358,5037,7395,2319,3007,4290,
3700,YLR399C,4760,2636,7396,5107,5241,2626,
3701,YDR245W,4193,3207,7400,2859,1992,2823,
3702,YLL064C,2902,4499,7401,174,718,176,
3703,YGR169C,4494,2909,7403,4477,4651,4353,
3704,YHR161C,3403,4000,7403,5584,5315,4234,
3705,YPR026W,2853,4552,7405,2724,2418,3043,
3706,YIL102C,5536,1871,7407,4904,4085,5038,
3707,YKL064W,1609,5803,7412,2685,2203,2805,
3708,YBR185C,3743,3669,7412,3307,3076,3422,
3709,YOR365C,2906,4511,7417,3839,2790,4933,
3710,YKR077W,1835,5584,7419,4956,4623,5283,
3711,YKL201C,5752,1668,7420,1419,3712,1133,
3712,YGR225W,1780,5640,7420,3585,2741,4615,
3713,YDR075W,3685,3737,7422,2056,1151,2868,
3714,YDL003W,3780,3642,7422,2927,1836,3112,
3715,YOR186W,3423,4001,7424,5061,6058,6119,
3716,YGL075C,2971,4453,7424,5085,5036,5364,
3717,YNL138W-A,4507,2917,7424,6515,6484,6459,
3718,YER156C,6178,1247,7425,3690,5642,1478,
3719,YOR314W,4083,3343,7426,5581,6272,5521,
3720,YLR104W,4034,3392,7426,4298,3952,5105,
3721,YKR071C,4718,2708,7426,1009,948,1511,
3722,YHL012W,2804,4623,7427,3240,1321,5126,
3723,YMR199W,2083,5346,7429,1584,2789,2873,
3724,YCR076C,5399,2032,7431,6453,5806,5237,
3725,YJR029W,2352,5085,7437,2361,3090,4177,
3726,YMR139W,5452,1986,7438,1985,2512,2722,
3727,YLR452C,3481,3957,7438,2080,1217,2564,
3728,YFL049W,3337,4105,7442,2935,2143,2652,
3729,YOL093W,4418,3026,7444,5620,5816,2781,
3730,YPR082C,3829,3616,7445,1297,2559,2055,
3731,YHR101C,2980,4467,7447,5070,4354,3908,
3732,YBL031W,3461,3986,7447,4097,4811,3638,
3733,YGL063W,1453,5994,7447,6628,6634,6498,
3734,YOR229W,5847,1602,7449,3362,5603,1777,
3735,YOR152C,2546,4904,7450,2527,1720,2933,
3736,YBR015C,3463,3988,7451,2678,4868,1960,
3737,YMR273C,2864,4588,7452,4874,5270,4237,
3738,YML040W,2557,4895,7452,2997,2471,3339,
3739,YEL007W,1579,5876,7455,1871,1044,3333,
3740,YPR067W,3764,3691,7455,4030,5023,5212,
3741,YIL014C-A,3936,3523,7459,3202,1813,3569,
3742,YMR286W,3797,3662,7459,6207,6077,5665,
3743,YOR313C,4090,3370,7460,3243,922,1955,
3744,YLR227W-B,2412,5049,7461,2272,2937,4467,
3745,YML052W,4898,2564,7462,3666,4982,2951,
3746,YDR014W,1824,5641,7465,2649,2550,3401,
3747,YML060W,4046,3419,7465,3600,4113,3027,
3748,YDR499W,2245,5221,7466,3740,2723,4720,
3749,YMR082C,2834,4634,7468,5856,6241,5909,
3750,YPR160W-A,5447,2022,7469,2526,3896,2035,
3751,YGR170W,2889,4580,7469,3623,3266,3510,
3752,YDR309C,3133,4336,7469,3519,4910,3475,
3753,YHR171W,4637,2835,7472,2395,965,3604,
3754,YOL129W,5092,2380,7472,4442,3736,4819,
3755,YLR396C,3897,3579,7476,4026,3542,5012,
3756,YJR146W,1096,6381,7477,6532,6432,6379,
3757,YMR022W,4312,3166,7478,3880,3594,4067,
3758,YGL172W,4669,2811,7480,6072,5147,3951,
3759,YPL034W,3041,4442,7483,3890,2928,5552,
3760,YHL048W,2716,4769,7485,4370,5171,4887,
3761,YOR267C,3775,3711,7486,756,625,1460,
3762,YIL091C,4056,3430,7486,1870,3303,1512,
3763,YEL059C-A,5679,1810,7489,6570,6594,5943,
3764,YNL051W,3092,4397,7489,2701,1465,2610,
3765,YIR021W,4528,2965,7493,5346,5860,5710,
3766,YLR339C,4122,3371,7493,6262,4800,5827,
3767,YLR105C,3269,4226,7495,4750,4754,4313,
3768,YBR167C,4640,2856,7496,1493,1180,2567,
3769,YNL167C,1515,5984,7499,4755,3495,5314,
3770,YKR003W,4560,2939,7499,1922,1335,2193,
3771,YFR042W,5381,2122,7503,4696,4314,4917,
3772,YKL089W,2956,4548,7504,3163,3129,2396,
3773,YHL010C,3283,4221,7504,4171,3749,3240,
3774,YDR013W,4660,2845,7505,3110,1367,3725,
3775,YHL014C,5116,2391,7507,3394,3492,2335,
3776,YGL142C,3436,4078,7514,4900,4239,5456,
3777,YGL116W,2789,4726,7515,3173,2114,3103,
3778,YMR047C,4799,2717,7516,4842,3471,2867,
3779,YLR438C-A,5862,1657,7519,6652,6615,6234,
3780,YOL031C,4737,2783,7520,2134,3881,2605,
3781,YMR238W,5018,2505,7523,1640,776,2571,
3782,YBR188C,5382,2142,7524,6272,5810,4674,
3783,YBR233W,3391,4135,7526,4386,5098,2971,
3784,YMR158W-B,2711,4815,7526,1447,1496,5295,
3785,YML034W,4176,3351,7527,4441,4287,3932,
3786,YDL111C,4100,3428,7528,5131,4951,5301,
3787,YDR433W,5274,2258,7532,6607,6372,3242,
3788,YHR045W,3262,4272,7534,4115,3196,4897,
3789,YDL056W,2870,4668,7538,3492,1947,3500,
3790,YGR283C,3514,4028,7542,4448,3925,4418,
3791,YMR025W,1783,5760,7543,2721,2461,5119,
3792,YBR081C,3556,3989,7545,2001,1800,2391,
3793,YKL058W,4505,3046,7551,6033,5646,4548,
3794,YJL157C,2727,4826,7553,3468,3704,3402,
3795,YBR246W,4522,3049,7571,4657,3579,4888,
3796,YJL113W,1763,5810,7573,1510,771,2760,
3797,YLR345W,3712,3861,7573,4841,4074,4553,
3798,YJR083C,3853,3720,7573,5255,4521,5167,
3799,YDR312W,3723,3853,7576,2664,1256,2137,
3800,YLR135W,2922,4655,7577,4246,2971,4144,
3801,YFL053W,4489,3091,7580,4281,4251,2820,
3802,YDR055W,4662,2919,7581,647,2112,749,
3803,YPL156C,4619,2964,7583,2833,2906,2454,
3804,YMR285C,3951,3634,7585,1841,1007,1834,
3805,YGL041C,4439,3147,7586,924,1656,1934,
3806,YEL072W,4043,3544,7587,4079,3964,5081,
3807,YJR026W,2542,5046,7588,3000,2467,3336,
3808,YLR465C,3769,3821,7590,2244,5735,3565,
3809,YGL222C,4021,3570,7591,4554,4554,4471,
3810,YDR512C,1734,5858,7592,6398,5680,5795,
3811,YDR261C-D,3037,4556,7593,2098,3032,4117,
3812,YHR100C,4930,2664,7594,1622,4116,3920,
3813,YOR135C,3675,3922,7597,5874,5417,5102,
3814,YML120C,3413,4186,7599,1950,3936,1182,
3815,YDR528W,1718,5883,7601,2989,2254,3711,
3816,YHR135C,4226,3376,7602,2519,3865,1376,
3817,YDR252W,4427,3176,7603,4414,2905,3161,
3818,YDL002C,3711,3896,7607,5779,4114,5203,
3819,YPL236C,4013,3597,7610,4395,4645,5789,
3820,YOR158W,5303,2309,7612,3032,2579,1942,
3821,YMR126C,2560,5052,7612,2769,1640,3905,
3822,YOR192C-B,3334,4281,7615,1754,1770,3996,
3823,YMR279C,3246,4371,7617,4769,4450,4442,
3824,YBR131W,2655,4967,7622,3785,4345,3580,
3825,YKR050W,3268,4357,7625,5530,6027,4130,
3826,YGR027W-B,2434,5194,7628,2369,3154,4295,
3827,YLR347W-A,4813,2817,7630,6534,5950,2996,
3828,YIL082W,2876,4755,7631,1323,3565,3460,
3829,YGL132W,4613,3024,7637,6172,5284,6045,
3830,YER027C,4311,3326,7637,2904,2841,2965,
3831,YGL066W,3532,4108,7640,4637,4220,3615,
3832,YMR115W,3998,3643,7641,4185,2924,2876,
3833,YDR061W,3622,4024,7646,5743,5269,5040,
3834,YJL132W,3324,4323,7647,3653,3312,4934,
3835,YPL112C,4259,3389,7648,4103,2968,4084,
3836,YNL048W,5346,2305,7651,2571,1092,2030,
3837,YGL166W,4288,3363,7651,5939,6159,5910,
3838,YMR245W,1915,5737,7652,5983,6379,6029,
3839,YDR302W,4319,3333,7652,1612,443,2844,
3840,YMR154C,3587,4073,7660,4545,3599,5368,
3841,YKL162C-A,3039,4622,7661,5071,6200,5337,
3842,YMR316C-B,3932,3732,7664,6588,6422,6153,
3843,YBR070C,3832,3832,7664,5725,4846,5801,
3844,YDR119W,4925,2742,7667,4081,3912,5247,
3845,YOR394W,4592,3076,7668,325,368,565,
3846,YML019W,4048,3622,7670,2622,2946,3966,
3847,YJL003W,5208,2463,7671,5938,4614,4885,
3848,YAL053W,3036,4636,7672,2787,4837,2236,
3849,YBR197C,4550,3123,7673,6185,6292,6161,
3850,YER023C-A,4926,2751,7677,5684,5590,3443,
3851,YER090C-A,4675,3004,7679,1260,3675,6522,
3852,YOR149C,3459,4220,7679,3450,3500,4802,
3853,YDL242W,3800,3879,7679,4852,5783,3879,
3854,YDL113C,4009,3671,7680,3055,2206,2279,
3855,YDL162C,3171,4509,7680,3497,5407,5741,
3856,YPL267W,4921,2761,7682,4932,4667,5444,
3857,YHL006W-A,4728,2955,7683,6252,5200,6470,
3858,YJR033C,4237,3447,7684,2627,2582,3414,
3859,YEL052W,5067,2618,7685,4570,4496,4882,
3860,YPL031C,5272,2413,7685,4977,5864,3009,
3861,R0020C,3625,4062,7687,5753,5213,5236,
3862,YDR286C,5546,2141,7687,2843,3410,4966,
3863,YJR027W,2369,5320,7689,2231,2874,4252,
3864,YCR069W,5074,2616,7690,2600,4872,1939,
3865,YNL032W,4435,3255,7690,5264,5698,5245,
3866,YDL186W,4094,3598,7692,5350,5681,5500,
3867,YBR098W,1300,6394,7694,5289,4003,5811,
3868,YHR218W-A,4625,3069,7694,6180,6069,4226,
3869,YGR096W,3548,4148,7696,5868,6311,5215,
3870,YOR026W,3815,3881,7696,3954,5034,4856,
3871,R0040C,4333,3364,7697,5501,5063,3720,
3872,YJL069C,5230,2467,7697,1637,1434,2332,
3873,YNL045W,5043,2656,7699,822,1144,1155,
3874,YFR012W-A,5556,2145,7701,3171,4956,2897,
3875,YLR006C,3227,4478,7705,5016,4175,5607,
3876,YPR104C,4858,2849,7707,5666,4474,4784,
3877,YFL001W,3827,3880,7707,2763,3748,2510,
3878,YOR083W,4055,3656,7711,6666,6654,6287,
3879,YMR077C,3642,4069,7711,5041,2752,5099,
3880,YAL067C,4876,2836,7712,979,529,1943,
3881,YDL152W,4362,3353,7715,4134,2791,4839,
3882,YGR102C,4873,2843,7716,5822,5544,4946,
3883,YPL113C,4924,2795,7719,3235,3765,2839,
3884,YDR181C,2958,4762,7720,4153,2798,3017,
3885,YJL175W,4816,2905,7721,5645,5254,4823,
3886,YLR227W-A,2424,5297,7721,2998,2474,3331,
3887,YPR029C,4555,3175,7730,3226,2719,2097,
3888,YER099C,6298,1432,7730,4301,3852,4355,
3889,YLR336C,3495,4235,7730,2637,1998,3258,
3890,YDR053W,4860,2871,7731,4583,5405,5866,
3891,YDL010W,4421,3312,7733,5118,4731,4716,
3892,YER085C,3507,4227,7734,6391,5985,6013,
3893,YKR038C,4204,3531,7735,5362,5442,4747,
3894,YBR125C,5353,2383,7736,4018,4927,4968,
3895,YLR419W,3644,4095,7739,2006,1515,1936,
3896,YOL162W,3024,4715,7739,3229,2531,5258,
3897,YKR095W-A,5304,2441,7745,6218,6469,6345,
3898,YBR276C,3637,4109,7746,4374,3907,5648,
3899,YDR150W,4271,3476,7747,2544,2452,1800,
3900,YJR112W-A,2994,4753,7747,6452,6510,5972,
3901,YPR070W,3558,4197,7755,2413,1911,4133,
3902,YOL020W,3182,4573,7755,4128,5393,3667,
3903,YGL036W,2635,5121,7756,2177,2533,3544,
3904,YHR073W,3736,4021,7757,4074,4270,3665,
3905,YDL247W,3819,3938,7757,4319,3452,3947,
3906,YPL153C,3093,4666,7759,4851,3717,3683,
3907,YCR047C,3967,3793,7760,6634,6635,4824,
3908,YAL048C,4458,3303,7761,3251,4379,2919,
3909,YOL099C,5036,2730,7766,3760,1393,4969,
3910,YLR308W,3663,4103,7766,1269,1263,3014,
3911,YCR014C,2140,5627,7767,2451,1824,2197,
3912,YOR346W,2750,5020,7770,3354,1925,3857,
3913,YLR205C,4289,3483,7772,5902,6384,3735,
3914,YLR424W,2246,5527,7773,3544,3250,4746,
3915,YGR288W,3400,4373,7773,5178,5311,5682,
3916,YGR121C,3339,4434,7773,5776,5504,3768,
3917,YBR042C,5144,2630,7774,3170,3335,4168,
3918,YGR110W,3885,3890,7775,3172,3246,4381,
3919,YHR177W,1770,6015,7785,5017,4876,5536,
3920,YLR232W,3580,4206,7786,5674,5214,5255,
3921,YPL033C,3100,4686,7786,4546,3514,5457,
3922,YGL240W,3320,4471,7791,5860,5485,4508,
3923,YLR170C,4531,3260,7791,4759,5286,4014,
3924,YKL036C,4264,3529,7793,6379,5629,6180,
3925,YDR028C,4040,3756,7796,2124,1522,2972,
3926,YDL221W,1952,5845,7797,6474,6391,6302,
3927,YEL057C,2366,5435,7801,2525,2975,4599,
3928,YNR047W,4045,3761,7806,3651,3917,3903,
3929,YDL030W,3830,3977,7807,4543,3866,3980,
3930,YBR199W,3499,4309,7808,3039,3320,3595,
3931,YER147C,4161,3647,7808,6561,6504,5977,
3932,YER044C-A,2116,5694,7810,4287,4409,5148,
3933,YKR037C,3491,4322,7813,3164,5016,2495,
3934,YDR258C,6324,1489,7813,1179,1068,1066,
3935,YDR411C,4584,3229,7813,5740,5721,5870,
3936,YOR079C,4468,3346,7814,3522,3327,5233,
3937,YMR177W,4621,3194,7815,2759,2421,2715,
3938,YGR028W,4932,2884,7816,3660,2429,2998,
3939,YLR369W,2289,5529,7818,2837,2074,2438,
3940,YJL098W,3820,3999,7819,2175,2603,2422,
3941,YHR178W,3248,4571,7819,4684,5087,4685,
3942,YMR140W,3881,3939,7820,2189,2088,2551,
3943,YMR302C,4826,2995,7821,2633,2703,1835,
3944,YGL111W,3102,4721,7823,4306,3893,3228,
3945,YLR247C,2160,5663,7823,3502,4162,3968,
3946,YOL102C,5540,2285,7825,5254,4964,4479,
3947,YPL274W,5052,2773,7825,2566,3310,2890,
3948,YOR028C,3567,4259,7826,4930,2581,4302,
3949,YIL082W-A,3173,4653,7826,3373,5484,4878,
3950,YMR032W,2908,4919,7827,4362,3862,3252,
3951,YHR132W-A,5320,2507,7827,5351,4148,5603,
3952,YOR366W,3851,3978,7829,5786,4526,6065,
3953,YLR307C-A,4428,3401,7829,2980,1986,3272,
3954,YDR307W,4280,3549,7829,2165,2433,4233,
3955,YBR171W,5073,2757,7830,2102,1689,1736,
3956,YDR106W,1612,6219,7831,3876,3906,5111,
3957,YBR284W,2207,5626,7833,4998,5082,5875,
3958,YPL183C,4189,3644,7833,2672,2893,4415,
3959,YJL026C-A,5902,1932,7834,6506,6130,3598,
3960,YER022W,2228,5607,7835,2087,2218,2736,
3961,YGL056C,4473,3362,7835,5358,4958,4547,
3962,YLL027W,5560,2278,7838,5797,6100,3225,
3963,YGL208W,1807,6034,7841,5924,5621,5415,
3964,YPL126W,4338,3503,7841,1344,2296,2005,
3965,YPL256C,3868,3973,7841,1486,3273,2814,
3966,YIL050W,4617,3225,7842,3806,4600,4648,
3967,YHR180W,3109,4733,7842,3895,4318,4378,
3968,YDL105W,1538,6304,7842,1946,2224,3994,
3969,YMR046C,3192,4654,7846,2557,2115,2968,
3970,YNL217W,4529,3322,7851,3897,5385,3200,
3971,YIL154C,5184,2668,7852,6539,6665,3111,
3972,YEL022W,4457,3396,7853,2147,1717,1861,
3973,YPR179C,4053,3804,7857,2733,1220,2840,
3974,YCR067C,4539,3318,7857,4013,2704,2853,
3975,YDL045C,5667,2192,7859,2829,3118,3348,
3976,YAR010C,3094,4766,7860,2981,2382,3230,
3977,YFR041C,3869,3991,7860,1761,1398,2027,
3978,YBR126W-B,5101,2762,7863,6525,6570,6539,
3979,YIL114C,4775,3089,7864,5256,5266,3074,
3980,YDR215C,3255,4609,7864,5974,6502,4214,
3981,YOR179C,4323,3542,7865,4236,5054,5469,
3982,YDR255C,3281,4586,7867,3248,2544,2665,
3983,YLR073C,2182,5686,7868,6182,6079,4518,
3984,YFL055W,3411,4458,7869,5088,4749,5093,
3985,YLR265C,4301,3573,7874,3482,1940,4364,
3986,YDR079C-A,4986,2888,7874,3926,3733,3579,
3987,YPL042C,2571,5304,7875,4860,3705,4605,
3988,YJL051W,1903,5973,7876,4423,4076,4973,
3989,YKL038W,3489,4388,7877,5456,5010,4280,
3990,YIL127C,5919,1959,7878,5498,3623,2854,
3991,YPL257W-B,2966,4912,7878,2349,3105,4334,
3992,YBR195C,4580,3298,7878,3728,4011,3113,
3993,YBL067C,2474,5410,7884,2106,1582,2902,
3994,YOR318C,5868,2017,7885,6028,5904,6261,
3995,YMR151W,3626,4261,7887,3873,4503,6105,
3996,YDR018C,3617,4271,7888,2849,3081,3362,
3997,YJL009W,2843,5045,7888,1105,5572,5357,
3998,YGL194C-A,5886,2002,7888,2881,4020,2142,
3999,YJL187C,2150,5748,7898,4166,3550,3550,
4000,YLR176C,1654,6245,7899,4893,4456,4970,
4001,YBR220C,3999,3903,7902,5554,5954,4658,
4002,YBL079W,4783,3121,7904,2416,2328,2455,
4003,YDR484W,4329,3578,7907,2119,812,3300,
4004,YJL004C,4674,3235,7909,5599,4774,6130,
4005,YOR348C,3590,4319,7909,6397,6514,3355,
4006,YDR440W,2921,4992,7913,3933,3714,3917,
4007,YLR088W,4877,3040,7917,3340,1268,4160,
4008,YNL056W,5350,2567,7917,5891,5793,5014,
4009,YHR061C,3396,4524,7920,3668,4366,4764,
4010,YDR425W,3210,4711,7921,2342,2802,2807,
4011,YML015C,4326,3595,7921,3464,5570,2334,
4012,YLR272C,3597,4325,7922,3311,2424,3159,
4013,YMR031W-A,2835,5090,7925,4809,4122,6293,
4014,YGR190C,5122,2805,7927,5663,4054,6129,
4015,YER058W,4039,3891,7930,6451,5637,5989,
4016,YPL047W,4912,3020,7932,5253,5624,3851,
4017,YDR403W,4995,2937,7932,1596,1296,2264,
4018,YMR021C,3735,4200,7935,3159,2187,4610,
4019,YMR240C,3064,4871,7935,5095,4778,2421,
4020,YNL046W,3890,4046,7936,6567,6480,5986,
4021,YGL138C,2426,5510,7936,3182,2126,3691,
4022,YLR149C,3428,4510,7938,2230,1839,3769,
4023,YAL034W-A,3975,3967,7942,6019,5533,5491,
4024,YOR208W,2199,5749,7948,2296,2012,3365,
4025,YDL122W,5435,2513,7948,1149,1008,1323,
4026,YPL130W,5410,2539,7949,1925,2058,3036,
4027,YDR265W,4153,3797,7950,3420,3949,4461,
4028,YER138C,3028,4923,7951,2298,2979,4255,
4029,YLR337C,4491,3462,7953,5928,3539,5539,
4030,YLR218C,3944,4009,7953,6128,6044,2484,
4031,YDR281C,2136,5817,7953,6466,6206,5707,
4032,YDR365W-B,3069,4884,7953,2233,3065,4205,
4033,YNL318C,4630,3324,7954,4091,2059,3555,
4034,YMR103C,4887,3067,7954,6645,6642,6591,
4035,YJL067W,3928,4026,7954,4492,6267,6295,
4036,YPR137C-A,3178,4779,7957,2987,2386,3239,
4037,YKL084W,4177,3784,7961,2089,4049,5733,
4038,YNL210W,4387,3574,7961,4706,4869,3310,
4039,YDL025C,4267,3696,7963,2325,2660,2491,
4040,YER034W,4817,3149,7966,6511,6497,5192,
4041,YBL088C,3488,4480,7968,3542,2681,4775,
4042,YNL180C,4565,3404,7969,4198,3343,4841,
4043,YBL005W-A,3316,4656,7972,2639,2013,2879,
4044,YDR495C,2845,5128,7973,2920,2390,4544,
4045,YPR177C,2554,5420,7974,3474,3928,5631,
4046,YOR320C,3524,4451,7975,2309,3213,2856,
4047,YJR037W,3416,4564,7980,5311,5913,5790,
4048,YOL124C,5298,2683,7981,3386,3214,1911,
4049,YGR072W,4394,3588,7982,2534,2465,1601,
4050,YBL044W,3588,4395,7983,6303,6495,6369,
4051,YJR054W,3569,4414,7983,2842,2236,4219,
4052,YJL090C,2739,5249,7988,2753,2309,3623,
4053,YHR119W,2232,5762,7994,3091,1957,2747,
4054,YEL049W,3664,4330,7994,216,457,211,
4055,YBL055C,5820,2174,7994,4834,3965,3632,
4056,YPL184C,5174,2821,7995,1746,1732,2658,
4057,YDR082W,4160,3836,7996,4162,3859,4425,
4058,YER165C-A,2692,5305,7997,1811,4772,5634,
4059,YDR066C,4297,3703,8000,5986,4858,6243,
4060,YJR090C,2372,5628,8000,3962,4069,5428,
4061,YML050W,3164,4837,8001,1350,1114,2681,
4062,YGR258C,1729,6272,8001,4937,4415,2443,
4063,YKL086W,4492,3511,8003,6672,6677,6113,
4064,YMR135C,1756,6249,8005,6236,6051,4800,
4065,YGL032C,3606,4399,8005,6170,4847,5329,
4066,YAR020C,5178,2828,8006,277,29,239,
4067,YLR338W,1599,6408,8007,6619,6125,6244,
4068,YJR003C,4850,3162,8012,2793,2521,3575,
4069,YBR245C,4423,3589,8012,1347,1078,1131,
4070,YCL044C,3646,4366,8012,5199,6151,4055,
4071,YDR374W-A,5277,2738,8015,6214,4046,5555,
4072,YFL062W,4562,3455,8017,3265,4201,4088,
4073,YLR130C,4230,3788,8018,4670,4619,4279,
4074,YPR105C,4959,3063,8022,3988,2750,3256,
4075,YBR196C-B,5037,2986,8023,6099,5930,4108,
4076,YMR306W,3219,4804,8023,4265,3568,4651,
4077,YPR079W,5099,2926,8025,4964,5891,2453,
4078,YPL183W-A,4441,3585,8026,5445,5622,2774,
4079,YKR032W,3243,4785,8028,4925,5799,6476,
4080,YBR047W,5777,2251,8028,2960,4235,5051,
4081,YMR212C,4393,3636,8029,2040,1799,3008,
4082,YGL247W,2778,5253,8031,5701,4679,6000,
4083,YOR381W,2047,5987,8034,3797,2764,5286,
4084,YOL070C,5228,2807,8035,5955,5705,3806,
4085,YJL155C,3194,4842,8036,3054,2094,2498,
4086,YOR278W,6021,2018,8039,3010,3678,3023,
4087,YGR268C,3987,4053,8040,6211,6040,6026,
4088,YDR415C,4482,3558,8040,3425,3924,2464,
4089,YJR018W,5070,2971,8041,6495,6529,6162,
4090,YGR281W,4070,3972,8042,1463,848,1501,
4091,YNL158W,2746,5299,8045,5098,5649,5136,
4092,YDR261C-C,3294,4752,8046,2993,2406,3319,
4093,YNL309W,2567,5482,8049,6046,5965,5256,
4094,YDL077C,3616,4433,8049,1868,2498,2894,
4095,YDR451C,2197,5853,8050,5110,5158,3277,
4096,YLL061W,5532,2518,8050,4472,5021,3774,
4097,YAL039C,4740,3311,8051,6161,6474,3021,
4098,YDL044C,4950,3101,8051,2882,3801,1927,
4099,YMR210W,3115,4937,8052,3838,3185,4332,
4100,YKR015C,4017,4036,8053,2448,2374,3405,
4101,YIR010W,2638,5418,8056,5801,4930,5010,
4102,YER148W-A,3482,4574,8056,5407,5532,6090,
4103,YDR090C,2519,5539,8058,1861,2456,3353,
4104,YLR381W,4011,4052,8063,3759,4489,5826,
4105,YPR011C,4843,3226,8069,5965,5441,5820,
4106,YPL158C,2270,5801,8071,3149,2117,2691,
4107,YOR038C,2210,5862,8072,3412,2765,3345,
4108,YPR002W,3142,4930,8072,5128,3860,4387,
4109,YBL066C,4140,3933,8073,3185,2560,3802,
4110,YOR110W,3273,4800,8073,3573,2160,3325,
4111,YDR473C,3938,4136,8074,3900,2620,2791,
4112,YNL065W,3016,5061,8077,2407,2086,3201,
4113,YOR292C,3051,5027,8078,5058,5052,6060,
4114,YJR053W,2564,5514,8078,2375,1644,3993,
4115,YNL025C,3380,4701,8081,2676,1782,3892,
4116,YOR371C,3010,5074,8084,2953,3414,4208,
4117,YNR039C,2841,5245,8086,4905,4683,5152,
4118,YHR205W,5008,3081,8089,1737,2894,2107,
4119,YML062C,5263,2829,8092,5769,4984,3454,
4120,YOR319W,4186,3906,8092,1828,1312,2058,
4121,YMR060C,3657,4437,8094,4632,3685,4533,
4122,YLR217W,2673,5421,8094,1888,5412,5958,
4123,YDR042C,2903,5191,8094,4284,4628,5401,
4124,YKR099W,3238,4857,8095,4429,2792,5144,
4125,YPR121W,5302,2793,8095,989,1119,1356,
4126,YKL119C,5816,2281,8097,4085,4419,5028,
4127,YLR097C,3568,4529,8097,1576,1595,3184,
4128,YJL032W,4187,3910,8097,1336,1606,3557,
4129,YJL185C,2526,5572,8098,5784,5850,5377,
4130,YCR018C,4663,3435,8098,3756,3689,4738,
4131,YGL261C,4419,3679,8098,242,969,228,
4132,YJR021C,4328,3773,8101,6237,6378,3708,
4133,YOL112W,2466,5636,8102,5824,5340,5520,
4134,YDR109C,4920,3183,8103,4821,3525,4078,
4135,YER001W,5065,3038,8103,1650,1735,2832,
4136,YKL047W,4561,3543,8104,3201,3046,4511,
4137,YER054C,3241,4864,8105,3716,3055,2984,
4138,YGR119C,4982,3126,8108,5758,3719,3731,
4139,YJR141W,5795,2313,8108,2517,2781,4457,
4140,YLR036C,4645,3466,8111,2967,2109,5410,
4141,YFL050C,3594,4519,8113,4643,3070,4549,
4142,YDR365W-A,3165,4948,8113,3148,2595,3383,
4143,YLL031C,4400,3714,8114,1367,1841,2186,
4144,YLR139C,2678,5436,8114,3923,5607,4342,
4145,YOR154W,4320,3794,8114,4295,3990,3138,
4146,YFL041W-A,1623,6492,8115,2766,4514,4368,
4147,YMR158C-A,6175,1940,8115,2200,930,5109,
4148,YOR297C,4171,3944,8115,3702,2720,5082,
4149,YFR039C,3950,4167,8117,4479,3456,3073,
4150,YJL072C,4390,3727,8117,4168,4103,3425,
4151,YGL027C,4006,4112,8118,2185,2327,2349,
4152,YBL023C,4385,3734,8119,1858,1591,1453,
4153,YPL074W,2972,5150,8122,5689,4974,5062,
4154,YNR063W,3638,4485,8123,4425,4171,5045,
4155,YFL054C,3919,4208,8127,5122,4553,5313,
4156,YBR083W,2507,5621,8128,4969,5201,4838,
4157,YBR139W,4089,4039,8128,2315,2882,3429,
4158,YDR065W,3873,4255,8128,3371,2232,3852,
4159,YBR146W,3257,4872,8129,3662,2589,4430,
4160,YPL077C,5721,2409,8130,5879,5765,5441,
4161,YBL006W-A,5031,3100,8131,5083,5100,4538,
4162,YPL257W,4185,3947,8132,3353,2031,5629,
4163,YJR100C,4360,3779,8139,4609,3488,5098,
4164,YLR157C-B,2999,5141,8140,2354,3120,4325,
4165,YGL218W,5279,2862,8141,4095,5291,4036,
4166,YLR121C,3790,4354,8144,5678,6307,2925,
4167,YCR050C,2064,6082,8146,6184,6194,5960,
4168,YDR003W-A,2995,5152,8147,1255,2377,5087,
4169,YGL023C,4357,3790,8147,6423,6392,4936,
4170,YBL009W,2969,5185,8154,3279,3155,3608,
4171,YBL006C,4665,3489,8154,6644,6541,6509,
4172,YLR374C,3726,4430,8156,6274,6397,5911,
4173,YCR008W,3308,4849,8157,2392,928,2913,
4174,YDR457W,2793,5364,8157,1994,2175,2720,
4175,YJR111C,6122,2035,8157,4385,4099,3858,
4176,YGR092W,5137,3021,8158,3023,2304,2588,
4177,YJL162C,4074,4088,8162,2966,1574,4379,
4178,YGR014W,5780,2385,8165,5066,3985,5321,
4179,YDR506C,3704,4466,8170,2302,3792,2727,
4180,YLL032C,4095,4076,8171,1756,1501,2753,
4181,YMR158W,5665,2506,8171,4412,4492,3716,
4182,YKL125W,4060,4111,8171,3042,3175,3247,
4183,YAL051W,2772,5402,8174,2297,2435,3992,
4184,YFR023W,4883,3291,8174,1664,690,2729,
4185,YKL074C,4252,3923,8175,3803,3676,3576,
4186,YBL074C,3607,4572,8179,2341,3077,2833,
4187,YKL155C,2370,5809,8179,3950,3499,2999,
4188,YOR354C,5401,2780,8181,2199,1845,2622,
4189,YOL163W,4334,3852,8186,4752,4561,3843,
4190,YDR164C,5603,2583,8186,1969,1862,1765,
4191,YDL209C,4356,3833,8189,5332,3267,5454,
4192,YGL199C,4801,3390,8191,6496,6446,5412,
4193,YOR363C,3688,4503,8191,3717,4247,3899,
4194,YKR058W,4262,3929,8191,1989,1745,2185,
4195,YPL216W,2038,6154,8192,4440,4193,5287,
4196,YNL276C,5666,2527,8193,5605,4414,5716,
4197,YGL092W,4601,3596,8197,3295,1647,2904,
4198,YDR170W-A,3457,4743,8200,2317,1516,3309,
4199,YDR262W,4188,4012,8200,4926,4555,4813,
4200,YJL027C,2607,5593,8200,6613,6658,6357,
4201,YEL061C,3891,4314,8205,2397,1785,2406,
4202,YBR202W,4825,3381,8206,2257,3257,2330,
4203,YGR109C,3953,4254,8207,1285,609,2723,
4204,YDL158C,3576,4632,8208,628,353,1918,
4205,YBR200W,5212,2997,8209,2638,1780,2124,
4206,YER166W,5416,2796,8212,1774,1593,1859,
4207,YIL072W,2317,5896,8213,4407,3774,3349,
4208,YOR298W,4117,4097,8214,3134,3585,5362,
4209,YDL034W,4000,4219,8219,5995,6234,5262,
4210,YPL124W,3845,4375,8220,5594,5235,6256,
4211,YDR356W,5407,2814,8221,2666,2226,1745,
4212,YDR003W,3516,4705,8221,5940,5392,5431,
4213,YPR137C-B,3184,5039,8223,2357,2980,4191,
4214,YBL016W,5310,2914,8224,6004,6354,5094,
4215,YOR279C,2990,5234,8224,4020,3540,4346,
4216,YPL219W,3600,4624,8224,3685,4921,4031,
4217,YPL151C,4080,4151,8231,5683,4720,5851,
4218,YGR093W,3649,4583,8232,4997,4424,4740,
4219,YFL064C,3494,4739,8233,5392,5775,5159,
4220,YJR071W,2188,6046,8234,5342,3336,5296,
4221,YMR316W,4572,3663,8235,5272,4432,4027,
4222,YPL229W,3730,4505,8235,3547,4832,4452,
4223,YDL133W,3907,4332,8239,4042,3478,3763,
4224,YDR524W-C,1581,6661,8242,2255,2080,6166,
4225,YLR144C,4623,3619,8242,1723,1304,3040,
4226,YGL061C,5269,2974,8243,3575,1569,2874,
4227,YLR138W,3379,4868,8247,4697,3512,4069,
4228,YEL009C-A,5225,3023,8248,5094,5829,6128,
4229,YGL086W,3976,4273,8249,2412,1443,3067,
4230,YER008C,3705,4547,8252,2667,2569,2360,
4231,YOR377W,4249,4004,8253,2324,2190,3326,
4232,YNL053W,2314,5939,8253,5933,5429,5773,
4233,YIR009W,4488,3767,8255,6412,6332,6393,
4234,YCL073C,3582,4673,8255,4774,4501,5315,
4235,YMR267W,4047,4209,8256,2845,2661,3381,
4236,YLR271W,5115,3143,8258,3008,2210,2824,
4237,YNL227C,4041,4217,8258,3017,2468,2558,
4238,YPL283W-A,2815,5448,8263,2285,5722,5837,
4239,YHR184W,5032,3237,8269,2262,808,2293,
4240,YMR119W,2838,5431,8269,2662,2547,4042,
4241,YHR136C,4410,3860,8270,6031,5892,3759,
4242,YOR299W,3583,4687,8270,5279,5459,4947,
4243,YBR282W,3972,4303,8275,3465,3477,1980,
4244,YOR162C,4332,3943,8275,2757,2587,3354,
4245,YLR458W,3095,5180,8275,5977,6009,6416,
4246,YMR153C-A,5417,2859,8276,3934,5159,5601,
4247,YDR524C,3369,4909,8278,2286,1310,4769,
4248,YBR012C,4734,3548,8282,3500,1373,6386,
4249,YGR129W,5629,2655,8284,4633,3741,2456,
4250,YKR106W,3562,4722,8284,4810,4394,5209,
4251,YMR064W,2223,6062,8285,4206,3448,5151,
4252,YOR382W,4985,3305,8290,512,1127,891,
4253,YER076W-A,2634,5657,8291,5637,5745,5868,
4254,YKL072W,3458,4833,8291,3364,3330,4556,
4255,YIL105C,4192,4100,8292,3855,2333,2932,
4256,YKL207W,5988,2307,8295,4404,4292,2513,
4257,YBL112C,5042,3253,8295,6178,6068,4225,
4258,YNL028W,4343,3953,8296,1610,4231,5248,
4259,YOL135C,3239,5057,8296,6459,6468,6037,
4260,YNL262W,4029,4268,8297,2336,1982,2800,
4261,YDL224C,4365,3934,8299,4690,3052,5143,
4262,YPR048W,5129,3171,8300,2161,2367,2598,
4263,YNR011C,4169,4131,8300,4150,3157,3707,
4264,YER137C-A,3404,4896,8300,3152,2609,3384,
4265,YML066C,3071,5229,8300,5906,5446,5876,
4266,YMR192W,3317,4990,8307,3346,2432,3750,
4267,YJL220W,4787,3522,8309,5412,6135,6622,
4268,YPL069C,3083,5228,8311,2558,3210,2713,
4269,YBR074W,5792,2523,8315,3793,3328,4743,
4270,YNL321W,3677,4641,8318,3788,5436,3973,
4271,YMR216C,5114,3206,8320,2437,3369,1864,
4272,YPR030W,2603,5717,8320,4131,3971,3895,
4273,YHR143W,3570,4751,8321,1722,900,1928,
4274,YLL029W,5140,3182,8322,3964,4802,2312,
4275,YLR368W,2663,5659,8322,4169,3166,5964,
4276,YPR199C,3525,4802,8327,5609,5015,5833,
4277,YOR386W,3156,5172,8328,1654,1006,2986,
4278,YHR099W,4092,4239,8331,2735,2711,3291,
4279,YKL015W,3747,4585,8332,1455,878,2271,
4280,YHR198C,6153,2179,8332,4426,4523,4661,
4281,YDL197C,3425,4908,8333,5903,5940,5288,
4282,YPR111W,3052,5281,8333,2816,2102,4180,
4283,YBR209W,4149,4185,8334,6155,5908,5132,
4284,YDL155W,4212,4122,8334,4339,4320,4705,
4285,YNL339W-A,2961,5373,8334,2287,5724,5838,
4286,YKL156C-A,3183,5154,8337,4420,2200,4949,
4287,YKR089C,2863,5474,8337,4853,4525,4352,
4288,YGR259C,4012,4326,8338,6307,5969,5667,
4289,YLR413W,5541,2798,8339,1113,1759,1385,
4290,YDR532C,2910,5432,8342,4832,3067,3479,
4291,YNL022C,4757,3586,8343,3366,2709,3010,
4292,YIL121W,5016,3328,8344,5525,5079,4606,
4293,YMR085W,5829,2515,8344,3607,3716,2584,
4294,YOL023W,5195,3152,8347,2838,2561,2045,
4295,YGR295C,4484,3866,8350,3592,4860,4827,
4296,YGL180W,4002,4348,8350,3128,1320,2777,
4297,YBR103W,5089,3263,8352,4973,4541,5231,
4298,YDR043C,2892,5461,8353,5457,3533,5997,
4299,YNL103W,4556,3798,8354,4797,5501,4259,
4300,YDR184C,5241,3115,8356,1558,955,2288,
4301,YGL160W,3367,4994,8361,3637,4044,4715,
4302,YIL012W,5821,2540,8361,5918,5941,5890,
4303,YPR054W,3683,4678,8361,5694,6099,5670,
4304,YJL100W,5082,3280,8362,5791,5700,5640,
4305,YER187W,6006,2356,8362,5937,5566,5807,
4306,YDR421W,2162,6204,8366,5121,4347,5361,
4307,YIL129C,4050,4316,8366,3762,2238,3589,
4308,YDR166C,4534,3834,8368,1619,1536,2039,
4309,YBL005W-B,3101,5267,8368,2429,2896,4566,
4310,YGL216W,3498,4873,8371,5411,5616,4688,
4311,YBL077W,2988,5389,8377,4693,3773,5888,
4312,YOR227W,4753,3625,8378,2771,2394,3794,
4313,YLR385C,4596,3783,8379,6254,5879,5165,
4314,YFR038W,2411,5971,8382,2383,2872,2145,
4315,YOL069W,4605,3778,8383,4317,4653,3241,
4316,YGR206W,4988,3397,8385,2488,2892,2251,
4317,YML012C-A,3358,5029,8387,6422,5707,6007,
4318,YMR045C,3483,4905,8388,2513,3049,4655,
4319,YBR073W,4984,3407,8391,3448,2909,4299,
4320,YNL050C,6058,2333,8391,4402,3544,3079,
4321,YLR278C,2768,5623,8391,3355,4091,4515,
4322,YHR109W,2882,5511,8393,3729,4455,4739,
4323,YPL195W,3783,4611,8394,1530,1326,1672,
4324,YKL055C,5787,2609,8396,3770,4029,3175,
4325,YDR407C,4167,4229,8396,2647,2659,2767,
4326,YPR159W,3670,4727,8397,1052,775,1974,
4327,YKL039W,4368,4031,8399,2180,2702,2073,
4328,YBR152W,5848,2553,8401,2889,4051,3434,
4329,YPR071W,4450,3952,8402,4196,3547,5370,
4330,YLR283W,5989,2414,8403,2559,4337,3480,
4331,YAR042W,5307,3099,8406,2538,5179,1571,
4332,YEL018C-A,5927,2479,8406,5744,5856,6474,
4333,YDL214C,2185,6221,8406,4334,4393,4480,
4334,YOL072W,3777,4633,8410,5575,5937,5901,
4335,YPR045C,4526,3885,8411,3285,3153,2717,
4336,YOR191W,4717,3698,8415,3684,3435,2828,
4337,YBR110W,5828,2587,8415,2153,1886,3396,
4338,YDR324C,5227,3190,8417,1259,1074,1532,
4339,YDL156W,3695,4723,8418,4713,5433,3530,
4340,YLR267W,3579,4839,8418,1912,3221,2618,
4341,YFR016C,6356,2062,8418,3187,2710,1573,
4342,YPL105C,4416,4003,8419,2629,2768,1707,
4343,YER190C-A,2898,5522,8420,2291,5726,5835,
4344,YGL178W,3381,5041,8422,1208,887,2613,
4345,YPR169W-A,6335,2088,8423,2607,4546,5674,
4346,YCL010C,4726,3700,8426,6343,6156,5481,
4347,YMR104C,5335,3096,8431,4699,4707,3949,
4348,YBR257W,3223,5209,8432,3919,3145,2296,
4349,YLR095C,3342,5091,8433,5261,5388,3147,
4350,YDR140W,5682,2753,8435,4901,3813,4899,
4351,YEL035C,2125,6311,8436,6584,6638,6445,
4352,YCR032W,3332,5106,8438,3673,3395,4768,
4353,YOR334W,3284,5155,8439,2249,4596,3337,
4354,YDR207C,5458,2982,8440,4409,5135,2607,
4355,YLR297W,4784,3657,8441,5579,5728,4602,
4356,YPR182W,4426,4015,8441,6661,6676,5841,
4357,YNL068C,3470,4972,8442,4533,4168,4550,
4358,YFL020C,5210,3233,8443,264,170,245,
4359,YGL034C,4795,3651,8446,6473,6317,6472,
4360,YPL282C,4948,3501,8449,326,367,566,
4361,YNR040W,5029,3420,8449,6009,6117,5395,
4362,YEL043W,4676,3774,8450,3068,3883,3515,
4363,YEL048C,6345,2106,8451,1955,1314,2917,
4364,YFL042C,4767,3684,8451,4996,5194,3387,
4365,YCR107W,5186,3265,8451,3348,4372,2916,
4366,YPL166W,4923,3530,8453,3591,763,4476,
4367,YPL115C,5196,3261,8457,3080,1550,4210,
4368,YMR294W-A,3180,5278,8458,5587,5843,5390,
4369,YNR003W-A,5326,3132,8458,2141,3889,2183,
4370,YNL294C,3557,4902,8459,5010,5348,3674,
4371,YDR104C,2781,5680,8461,4053,3834,4993,
4372,YIR023C-A,4175,4286,8461,6121,4857,6031,
4373,YOL117W,2934,5531,8465,3264,3572,3359,
4374,YIL177C,3849,4617,8466,6015,6168,5503,
4375,YMR225C,5652,2815,8467,3877,4976,3766,
4376,YJL096W,4650,3817,8467,1962,1728,1965,
4377,YLR453C,3710,4758,8468,2561,3332,4398,
4378,YPL137C,5021,3449,8470,2005,2554,2067,
4379,YGR140W,2364,6108,8472,2930,1859,3144,
4380,YPL022W,3934,4538,8472,4678,3926,3782,
4381,YKR082W,5689,2785,8474,2549,2633,2881,
4382,YOL108C,3352,5122,8474,6277,6007,4920,
4383,YLR322W,4195,4280,8475,1065,4296,6022,
4384,YJL029C,5219,3257,8476,3914,4748,3810,
4385,YOR134W,2799,5681,8480,4447,3754,4543,
4386,YJR046W,5193,3287,8480,6043,5779,4943,
4387,YPL021W,3407,5076,8483,5655,4548,6208,
4388,YER183C,2904,5580,8484,4675,4404,5131,
4389,YPL011C,3563,4921,8484,4537,3715,4741,
4390,YNL196C,3686,4799,8485,2917,3360,3594,
4391,YCL004W,3913,4575,8488,4589,3462,4614,
4392,YDL074C,3193,5303,8496,3724,3212,3154,
4393,YMR258C,4684,3814,8498,2683,3536,3830,
4394,YHR156C,5030,3469,8499,2695,2742,4321,
4395,YMR163C,2194,6305,8499,4466,3993,5692,
4396,YMR044W,3048,5452,8500,5130,4702,2155,
4397,YGR113W,4786,3715,8501,4391,4299,2929,
4398,YDR525W-A,4632,3871,8503,5418,5921,5320,
4399,YOL024W,3439,5065,8504,5067,1762,5660,
4400,YOR302W,4099,4408,8507,406,5359,1135,
4401,YDR521W,5285,3223,8508,4802,3959,5171,
4402,YBR120C,2652,5856,8508,3093,2347,2141,
4403,YOL137W,4732,3776,8508,2458,1173,4232,
4404,YOR221C,4870,3640,8510,2977,4090,3085,
4405,YJL212C,4028,4483,8511,1423,3738,1651,
4406,YPR051W,4647,3865,8512,6341,6346,4375,
4407,YNR059W,5327,3188,8515,4970,4799,5473,
4408,YMR164C,3552,4965,8517,2663,1600,3684,
4409,YOL051W,3901,4619,8520,2592,2295,1403,
4410,YJL057C,5153,3368,8521,3545,2808,3140,
4411,YGR171C,5009,3514,8523,2921,2888,3954,
4412,YLR071C,4096,4432,8528,3272,2629,2883,
4413,YPL099C,4245,4284,8529,4942,4666,4043,
4414,YGR296C-A,3086,5445,8531,2289,5723,5840,
4415,YNR010W,4667,3870,8537,4043,4624,5584,
4416,YKL057C,5561,2977,8538,1441,1046,3921,
4417,YDR073W,2719,5820,8539,6512,5983,6199,
4418,YIL096C,5342,3197,8539,3132,2375,3592,
4419,YBR255W,3282,5258,8540,4824,3979,4980,
4420,YDR034C,3263,5277,8540,2940,1889,4175,
4421,YIL002C,3022,5521,8543,4634,3588,5142,
4422,YLR157C-A,3373,5177,8550,3151,2608,3389,
4423,YOR059C,3698,4853,8551,5198,4411,4562,
4424,YML133W-A,2948,5603,8551,2284,5719,5839,
4425,YDR079W,5490,3062,8552,6048,2415,3295,
4426,YIL171W-A,4815,3738,8553,5409,6133,6621,
4427,YDR089W,4300,4256,8556,3345,3116,4057,
4428,YPL017C,4402,4157,8559,6454,6237,4853,
4429,YIL106W,2770,5790,8560,5541,4560,5478,
4430,YCR104W,5130,3433,8563,213,253,195,
4431,YDR221W,5378,3185,8563,3238,4236,2810,
4432,YJR124C,4603,3960,8563,2703,2308,3407,
4433,YOR212W,4374,4190,8564,3433,2121,4462,
4434,YML081C-A,2483,6083,8566,1396,792,2761,
4435,YHR080C,2256,6312,8568,4170,3534,3680,
4436,YLR189C,4788,3781,8569,4223,2697,3428,
4437,YIL022W,5730,2842,8572,5831,6129,1894,
4438,YIL068C,4599,3976,8575,2866,2312,3745,
4439,YBR140C,4317,4258,8575,2616,2066,3440,
4440,YLL037W,3906,4671,8577,3321,4929,6001,
4441,YNL199C,3085,5493,8578,5966,4896,5756,
4442,YOR190W,5383,3196,8579,2143,1958,2412,
4443,YPL257W-A,3537,5043,8580,3153,2602,3386,
4444,YBR058C-A,4073,4508,8581,2892,3976,5445,
4445,YOR328W,4113,4472,8585,4530,3951,4584,
4446,YMR290W-A,4553,4035,8588,5054,3898,5858,
4447,YJR092W,4054,4535,8589,2852,2918,3032,
4448,YGL243W,5596,2998,8594,4827,3687,4815,
4449,YKR061W,3801,4793,8594,2835,3408,4852,
4450,YGR296W,5253,3342,8595,6064,6164,5647,
4451,YBR108W,3986,4610,8596,5941,5041,4301,
4452,YLR132C,2737,5859,8596,4899,5387,6135,
4453,YKR060W,5922,2678,8600,2278,4557,2162,
4454,YBL108W,3958,4642,8600,5805,5482,6318,
4455,YOL159C-A,5060,3540,8600,3428,3555,5995,
4456,YLR397C,4573,4027,8600,4576,3931,3283,
4457,YOL076W,4571,4029,8600,1847,1623,2314,
4458,YMR087W,3824,4777,8601,5271,4002,5754,
4459,YFL017W-A,5901,2700,8601,5531,5880,4061,
4460,YIL173W,3506,5096,8602,2077,1575,2366,
4461,YIL119C,3485,5119,8604,1526,706,2300,
4462,YML112W,5226,3380,8606,3754,5801,3060,
4463,YDR526C,5707,2901,8608,5724,4482,5996,
4464,YAR009C,3302,5309,8611,1842,2708,3855,
4465,YLR116W,3466,5146,8612,5454,4925,5138,
4466,YIL067C,4197,4417,8614,5481,4398,5619,
4467,YDR067C,3448,5167,8615,3188,1624,5806,
4468,YCR044C,5311,3308,8619,3453,5027,3849,
4469,YHR062C,4455,4165,8620,6020,6309,5016,
4470,YLR352W,3696,4926,8622,1648,1887,2909,
4471,YJR116W,4215,4410,8625,5221,6444,3050,
4472,YNL129W,4314,4312,8626,2767,1586,2939,
4473,YNL339C,5254,3372,8626,6065,6171,5639,
4474,YPR083W,4110,4516,8626,3939,3996,3718,
4475,YLR032W,4214,4415,8629,3466,2448,2733,
4476,YGL059W,4052,4579,8631,2044,2130,3756,
4477,YJL163C,3247,5385,8632,5993,5808,5704,
4478,YMR153W,4451,4181,8632,5182,4212,4136,
4479,YDR132C,2699,5933,8632,3244,3294,4317,
4480,YDL063C,5623,3009,8632,4158,2938,4513,
4481,YBR130C,5155,3480,8635,2366,1266,2794,
4482,YJL091C,4049,4590,8639,2893,1936,3488,
4483,YNL042W-B,3357,5282,8639,5968,6050,3160,
4484,YBL062W,3479,5160,8639,3817,2767,6292,
4485,YIR003W,6323,2316,8639,5007,4063,2547,
4486,YDR185C,4478,4161,8639,5590,6081,5944,
4487,YNL272C,4141,4500,8641,2874,2306,2566,
4488,YJR004C,2775,5869,8644,3516,2180,4483,
4489,YEL019C,4901,3744,8645,2032,2489,3124,
4490,YOR084W,5793,2853,8646,6573,6646,4805,
4491,YKL162C,2147,6500,8647,4469,4140,5369,
4492,YLR096W,4608,4044,8652,3821,2342,3453,
4493,YLL048C,5141,3513,8654,1050,1019,1455,
4494,YAL027W,4549,4107,8656,4906,4757,3700,
4495,YGL110C,3678,4978,8656,3395,2128,2520,
4496,YLR254C,4716,3941,8657,5897,5612,5373,
4497,YER098W,3748,4911,8659,3224,2239,3736,
4498,YHR015W,5371,3290,8661,2344,767,2367,
4499,YML096W,5180,3485,8665,5175,3762,5532,
4500,YLR233C,3355,5313,8668,3410,2904,4466,
4501,YEL006W,4282,4390,8672,5195,2666,5418,
4502,YGL010W,5594,3088,8682,4247,4303,5128,
4503,YKL124W,4065,4626,8691,2909,2820,2488,
4504,YNL162W-A,5836,2857,8693,2481,2989,5965,
4505,YJL225C,3864,4829,8693,6012,6172,5492,
4506,YKR090W,4236,4459,8695,4808,4879,3227,
4507,YCR049C,5766,2929,8695,6287,6618,5745,
4508,YPL283C,5308,3388,8696,6063,6166,5645,
4509,YML003W,2535,6162,8697,3820,3370,5933,
4510,YLR099W-A,4940,3757,8697,6642,6631,5784,
4511,YLR117C,3701,4996,8697,3872,2932,4149,
4512,YIR011C,4359,4339,8698,4933,4385,4458,
4513,YEL029C,5439,3259,8698,2869,1919,3931,
4514,YGR163W,4967,3733,8700,5217,3698,3305,
4515,YLR049C,3401,5300,8701,2624,3769,4026,
4516,YDR081C,4037,4665,8702,2693,1106,4170,
4517,YOR305W,5692,3013,8705,4631,3491,5284,
4518,YCL056C,4849,3857,8706,5368,4520,6085,
4519,YDR545W,3921,4786,8707,6141,6217,5718,
4520,YNR005C,5510,3200,8710,5533,5574,5941,
4521,YPR158C-C,3931,4781,8712,3079,2399,3328,
4522,YJR138W,3144,5570,8714,2384,1671,3052,
4523,YHR173C,3884,4832,8716,5347,4297,5932,
4524,YOR396W,3804,4913,8717,6140,6219,5720,
4525,YNL039W,3374,5344,8718,3854,3334,2615,
4526,YPL194W,3264,5456,8720,4397,4240,3704,
4527,YMR242W-A,4724,3996,8720,6612,6325,2248,
4528,YDR145W,4134,4587,8721,5002,2454,2846,
4529,YPR031W,3440,5285,8725,2508,1801,4285,
4530,YIR020C-B,5152,3576,8728,5651,5435,6171,
4531,YLR361C,4888,3843,8731,4011,4105,3563,
4532,YAR018C,5229,3502,8731,4121,4189,5089,
4533,YNL185C,3990,4744,8734,6240,4472,4320,
4534,YLL014W,6525,2213,8738,4290,4797,4867,
4535,YOL144W,4976,3764,8740,3563,2845,2307,
4536,YGR004W,4405,4335,8740,3896,2253,4420,
4537,YDL020C,2728,6018,8746,2938,3427,3458,
4538,YIL009C-A,2749,5998,8747,5448,5076,5005,
4539,YDR437W,3301,5447,8748,5129,5498,4935,
4540,YJR010C-A,5322,3427,8749,5892,3508,4986,
4541,YMR094W,3732,5017,8749,3674,3864,5624,
4542,YLR035C,2681,6069,8750,4394,4137,4862,
4543,YNL229C,5583,3167,8750,3183,2759,4198,
4544,YCL068C,4501,4253,8754,5631,6294,5688,
4545,YOL034W,2821,5937,8758,2120,1556,1475,
4546,YDR182W-A,4989,3770,8759,1935,1040,1769,
4547,YER161C,5158,3601,8759,5524,4988,2327,
4548,YOR258W,3300,5462,8762,2936,3538,5729,
4549,YJL152W,3816,4947,8763,6600,6623,6228,
4550,YOL045W,4084,4683,8767,2263,1670,2808,
4551,YLR288C,4350,4418,8768,5109,5247,5604,
4552,YMR253C,5483,3286,8769,4467,4259,3119,
4553,YFR017C,5897,2872,8769,5790,6517,3132,
4554,YBR251W,4934,3835,8769,3840,3505,3146,
4555,YER154W,5563,3208,8771,4446,5818,2990,
4556,YKL146W,5024,3748,8772,6089,6085,4982,
4557,YDR162C,6045,2731,8776,5258,3697,3662,
4558,YOR275C,5639,3137,8776,4034,2900,3540,
4559,YGL118C,3846,4933,8779,2894,755,4194,
4560,YBR007C,3120,5662,8782,4494,2570,5246,
4561,YPL133C,3340,5446,8786,5819,5606,5336,
4562,YIR018W,3787,5000,8787,5890,6249,5146,
4563,YBR201W,3658,5129,8787,4257,5246,5559,
4564,YOR127W,4376,4412,8788,4084,2912,5553,
4565,YGL175C,4861,3928,8789,4976,4805,3877,
4566,YIL046W,4119,4670,8789,6044,6436,5512,
4567,YHL027W,4363,4427,8790,4019,4835,3207,
4568,YLR400W,3974,4817,8791,4094,5658,6276,
4569,YGR237C,3349,5442,8791,3327,2157,2934,
4570,YDR436W,4811,3983,8794,5958,5773,5027,
4571,YBR239C,3528,5268,8796,4428,5668,4697,
4572,YDR253C,5412,3386,8798,4552,1507,3413,
4573,YPR076W,4941,3858,8799,6470,5949,6008,
4574,YLR063W,4499,4301,8800,3688,4665,4238,
4575,YDR515W,4847,3955,8802,1242,780,1985,
4576,YBR150C,2664,6139,8803,2734,2122,4403,
4577,YDR439W,3895,4910,8805,5600,4184,4964,
4578,YJL073W,4389,4416,8805,3540,3868,4218,
4579,YOL019W,3794,5011,8805,3546,4289,4501,
4580,YDR277C,4470,4341,8811,5426,4705,4734,
4581,YPL087W,2732,6080,8812,1771,2145,2787,
4582,YML133C,4168,4645,8813,6136,6263,5440,
4583,YDR182W,3454,5361,8815,3731,2148,4426,
4584,YEL005C,4808,4008,8816,4473,3377,4284,
4585,YBR259W,2964,5852,8816,3486,2930,4372,
4586,YPL188W,4746,4071,8817,3751,2286,4009,
4587,YER079C-A,4742,4077,8819,6421,6018,6581,
4588,YBR095C,4781,4038,8819,2740,2860,2051,
4589,YOR018W,2888,5931,8819,4417,3686,5278,
4590,YIL088C,4903,3920,8823,4483,3740,4367,
4591,YHL020C,3988,4835,8823,6543,6503,3827,
4592,YLR415C,2530,6294,8824,6620,6600,6229,
4593,YPL264C,5181,3648,8829,4514,4305,5030,
4594,YLR183C,3326,5509,8835,3511,3339,2506,
4595,YGL133W,4463,4372,8835,2645,2520,2698,
4596,YGL013C,4627,4210,8837,3089,3692,4137,
4597,YOR337W,5352,3486,8838,4054,5317,4641,
4598,YKL102C,5162,3677,8839,6117,6015,5842,
4599,YBR044C,3966,4874,8840,4594,4729,4875,
4600,YHL032C,6385,2455,8840,4681,5839,2928,
4601,YJL222W,3655,5187,8842,2117,1605,2380,
4602,YDL039C,3175,5668,8843,1289,1411,2238,
4603,YBR211C,2900,5943,8843,4256,4269,4958,
4604,YOL013C,3235,5611,8846,4581,3895,5063,
4605,YNL067W-A,2992,5855,8847,2047,2132,6146,
4606,YMR144W,3733,5114,8847,5625,4912,5869,
4607,YLR119W,3714,5133,8847,3430,1934,3752,
4608,YDR511W,5332,3518,8850,4789,5960,4913,
4609,YFL026W,4248,4603,8851,2908,1342,3329,
4610,YER107C,5281,3572,8853,4840,2318,5463,
4611,YHL024W,4641,4212,8853,1303,1336,2022,
4612,YER124C,3018,5837,8855,1682,1049,3688,
4613,YDR283C,4093,4763,8856,2487,1387,4004,
4614,YDR443C,2977,5884,8861,3894,3922,3573,
4615,YAR002W,3383,5483,8866,3337,2202,3029,
4616,YLR152C,3068,5799,8867,4460,2903,4689,
4617,YJR080C,5717,3150,8867,4184,4160,2922,
4618,YPR175W,5027,3840,8867,2523,3302,2556,
4619,YOR034C,4019,4848,8867,3859,4511,4921,
4620,YOR268C,3236,5634,8870,5267,6174,5100,
4621,YER169W,3392,5478,8870,5345,4576,4703,
4622,YJL062W,3689,5182,8871,4757,5094,4624,
4623,YDL109C,4136,4736,8872,4625,5072,4883,
4624,YGR227W,3899,4974,8873,2162,3004,4519,
4625,YPR078C,4218,4657,8875,3389,3097,5196,
4626,YOR219C,4127,4749,8876,2265,3018,3064,
4627,YOL003C,3935,4942,8877,3406,3445,4903,
4628,YGL131C,3197,5684,8881,3223,2419,5221,
4629,YER116C,4283,4600,8883,4845,4806,4045,
4630,YIR020W-A,4730,4155,8885,6038,4367,4865,
4631,YLR226W,4869,4018,8887,2905,1023,3238,
4632,YNL214W,3549,5338,8887,4940,4112,5406,
4633,YNR008W,4991,3897,8888,3990,4531,3584,
4634,YLR256W,4278,4612,8890,2654,3556,2785,
4635,YLR219W,3838,5056,8894,5423,4923,3564,
4636,YLR018C,2946,5949,8895,6198,6232,5348,
4637,YHR033W,4800,4096,8896,6441,6621,3823,
4638,YDL007C-A,3908,4989,8897,4960,5123,4840,
4639,YBR105C,4897,4002,8899,4914,5020,3417,
4640,YDL203C,5397,3504,8901,4980,3605,4791,
4641,YNL095C,4779,4124,8903,3912,3545,3737,
4642,YBL111C,3370,5535,8905,6346,6357,5878,
4643,YER163C,4576,4329,8905,6282,6131,5611,
4644,YDR479C,4381,4525,8906,5132,4764,5216,
4645,YER039C,4814,4092,8906,5816,5837,3370,
4646,YGL136C,4201,4706,8907,3013,4466,4718,
4647,YOR289W,5494,3416,8910,4793,3361,4796,
4648,YIL004C,5883,3031,8914,5657,4312,4842,
4649,YBR153W,5068,3847,8915,5839,4326,6118,
4650,YDR204W,6015,2900,8915,5510,5452,2812,
4651,YML006C,4036,4879,8915,2259,2007,4059,
4652,YLR253W,4331,4589,8920,4799,5024,4681,
4653,YNL042W,4541,4379,8920,4239,4081,5327,
4654,YFL036W,5566,3359,8925,1515,869,1679,
4655,YJL207C,4812,4114,8926,2700,2191,3786,
4656,YLR124W,3792,5134,8926,5396,5218,6169,
4657,YDR093W,5314,3613,8927,3320,3816,2428,
4658,YGL117W,3259,5669,8928,2808,4701,4193,
4659,YHR181W,4768,4160,8928,3991,4282,4972,
4660,YLR316C,5987,2942,8929,6263,6336,5543,
4661,YBR266C,3256,5674,8930,5296,4977,5808,
4662,R0010W,3795,5138,8933,5441,3983,5534,
4663,YPL089C,2801,6133,8934,4204,4536,3998,
4664,YDR477W,6156,2779,8935,1282,1804,1709,
4665,YLR341W,4466,4470,8936,1724,2151,2944,
4666,YMR284W,4853,4083,8936,2363,1288,2803,
4667,YGL123C-A,3394,5542,8936,6223,5677,6254,
4668,YDL023C,5191,3752,8943,6130,4669,4187,
4669,YER007W,5093,3851,8944,2868,4024,4664,
4670,YDL013W,3099,5849,8948,5883,5613,5809,
4671,YJR056C,4908,4041,8949,5858,5711,6041,
4672,YOR345C,4059,4893,8952,5969,3398,6307,
4673,YPR066W,4709,4249,8958,6110,6115,5079,
4674,YMR223W,4824,4134,8958,1498,1597,3728,
4675,YKL076C,5756,3202,8958,4811,2927,4794,
4676,YJL137C,5325,3638,8963,3417,4031,3911,
4677,YBR023C,5242,3723,8965,1567,1303,2433,
4678,YDR444W,3472,5494,8966,5627,5116,4730,
4679,YER047C,4577,4389,8966,4159,3227,4384,
4680,YOR108C-A,4417,4550,8967,856,5215,2825,
4681,YDR389W,3492,5477,8969,4415,4050,4693,
4682,YBR147W,4174,4795,8969,4330,3784,4709,
4683,YGL169W,5589,3384,8973,5119,2970,5294,
4684,YIL005W,3758,5216,8974,3088,3060,1997,
4685,YDL087C,4239,4735,8974,6498,6481,5070,
4686,YDL159C-B,4454,4520,8974,1911,414,2687,
4687,YDR116C,4670,4305,8975,5186,2994,4212,
4688,YDR268W,6129,2848,8977,4183,3308,2815,
4689,YBR198C,5006,3971,8977,3946,3888,3574,
4690,YER170W,3453,5525,8978,6297,5895,6143,
4691,YNL224C,4851,4127,8978,2542,2643,2317,
4692,YDL151C,3898,5080,8978,6186,5675,5953,
4693,YBR288C,4182,4797,8979,3396,2068,3539,
4694,YDR113C,4896,4087,8983,4962,4568,2586,
4695,YLR120C,3211,5774,8985,3227,4618,2923,
4696,YAL026C-A,4999,3990,8989,5400,5547,6478,
4697,YLR246W,3745,5244,8989,5231,4962,5609,
4698,YHR097C,6329,2663,8992,5291,5327,2324,
4699,YPR126C,5613,3379,8992,6200,6610,6221,
4700,YDR337W,5213,3780,8993,4553,3425,1753,
4701,YDR452W,5813,3181,8994,2580,3089,1668,
4702,YBR065C,3445,5554,8999,5465,4777,5590,
4703,YNL133C,6387,2613,9000,5861,4310,4736,
4704,YLR455W,5550,3456,9006,4232,2835,3537,
4705,YBR157C,4299,4708,9007,4267,3963,4500,
4706,YNL257C,3854,5153,9007,3723,3230,4634,
4707,YFL024C,5339,3670,9009,2754,2942,2427,
4708,YER162C,3656,5354,9010,4217,3382,3180,
4709,YPL120W,5703,3310,9013,2954,3030,3714,
4710,YMR059W,3768,5246,9014,5922,5409,6002,
4711,YOR336W,5457,3557,9014,2137,1628,2806,
4712,YNL260C,4712,4306,9018,2579,935,3363,
4713,YBL010C,4448,4570,9018,4816,4621,5322,
4714,YMR078C,3353,5666,9019,3517,3137,3118,
4715,YDR466W,3286,5735,9021,4907,3666,4872,
4716,YBR136W,3382,5642,9024,3005,2779,3836,
4717,YBR004C,5091,3936,9027,1384,772,3072,
4718,YLR054C,3862,5168,9030,4350,3333,4948,
4719,YCR094W,5362,3672,9034,2698,1355,3232,
4720,YOL025W,4532,4507,9039,4443,4405,4258,
4721,YMR251W,4680,4360,9040,6134,6440,5462,
4722,YKL202W,3003,6037,9040,2045,1111,6651,
4723,YCL054W-A,3072,5970,9042,2841,5971,6039,
4724,YOR181W,4891,4152,9043,5927,3627,4568,
4725,YMR231W,3939,5108,9047,3415,2507,3547,
4726,YNL192W,4444,4604,9048,1921,1185,2799,
4727,YMR301C,5167,3884,9051,5215,5046,3970,
4728,YDL096C,4668,4384,9052,6331,6289,5461,
4729,YFR034C,4372,4682,9054,6653,6668,6242,
4730,YDR490C,4822,4236,9058,5818,5507,3828,
4731,YAL001C,2822,6237,9059,4534,3528,3587,
4732,YBL013W,4820,4240,9060,6581,6534,6004,
4733,YNL186W,5650,3410,9060,1823,2381,1617,
4734,YDR537C,5786,3275,9061,5662,4551,6156,
4735,YER167W,4748,4315,9063,3231,3480,3586,
4736,YDR222W,5720,3347,9067,1180,1317,2621,
4737,YDR128W,4629,4439,9068,4294,3747,5213,
4738,YLR382C,3420,5651,9071,3581,3123,3055,
4739,YAL037W,3981,5093,9074,6002,5453,6049,
4740,YGL236C,4785,4292,9077,5907,6148,2656,
4741,YMR257C,3124,5954,9078,3273,2450,4585,
4742,YOR193W,3571,5507,9078,3147,2344,5483,
4743,YLR154W-F,5004,4090,9094,3441,1124,6418,
4744,YPR131C,3681,5414,9095,2060,2913,4052,
4745,YLR203C,4996,4099,9095,3494,4646,2121,
4746,YPL177C,2656,6441,9097,5542,5345,5112,
4747,YNL183C,4998,4101,9099,3028,2055,4526,
4748,YJL054W,4198,4901,9099,3467,4123,2918,
4749,YML046W,3084,6017,9101,3141,1973,4115,
4750,YNL203C,4508,4593,9101,5567,4808,6317,
4751,YLR047C,2755,6348,9103,3625,3658,4863,
4752,YLR260W,4125,4980,9105,4564,4203,4711,
4753,YNL329C,3721,5384,9105,4771,3663,5057,
4754,YKR017C,4809,4296,9105,1671,1229,4349,
4755,YJL120W,4027,5079,9106,2203,4795,6374,
4756,YIL015W,2985,6124,9109,4111,2563,4306,
4757,YJL210W,4955,4154,9109,6426,6199,5529,
4758,YBR215W,4974,4138,9112,2345,1071,2114,
4759,YMR141W-A,3001,6111,9112,4974,5790,5738,
4760,YPR174C,3930,5183,9113,6188,6315,5662,
4761,YNL242W,4690,4425,9115,4685,4088,4609,
4762,YPL096C-A,6426,2691,9117,5634,6139,6246,
4763,YBR122C,5671,3446,9117,1964,3224,2381,
4764,YGL194C,4216,4903,9119,3629,3602,4927,
4765,YKR022C,5069,4055,9124,4839,4719,3127,
4766,YAL043C,5064,4060,9124,5870,6242,3446,
4767,YMR195W,4867,4264,9131,3400,4500,3844,
4768,YPL253C,4076,5060,9136,2331,3098,3031,
4769,YPR141C,3817,5325,9142,4347,2037,3089,
4770,YMR291W,5078,4065,9143,1501,3515,1865,
4771,YPR124W,5514,3631,9145,3404,3254,4037,
4772,YJL168C,5216,3930,9146,3787,3365,2595,
4773,YLR444C,5232,3914,9146,6373,5920,6517,
4774,YDR370C,4744,4403,9147,3487,2413,5047,
4775,YLL063C,3924,5224,9148,4812,5401,5602,
4776,YLL042C,3364,5791,9155,3833,4138,6376,
4777,YGL144C,3654,5501,9155,3203,2770,4333,
4778,YBL014C,2927,6230,9157,4765,4606,5125,
4779,YNL127W,4194,4966,9160,3780,2819,4028,
4780,YBL049W,5695,3465,9160,2300,4504,5230,
4781,YNL254C,6057,3104,9161,5577,4992,4096,
4782,YBR275C,4256,4907,9163,3960,2773,4223,
4783,YBR116C,4579,4584,9163,6138,5708,6176,
4784,YML113W,4558,4608,9166,6574,6412,5222,
4785,YER168C,5039,4128,9167,3444,3002,3262,
4786,YOL009C,5046,4121,9167,5281,3586,5861,
4787,YDL001W,5294,3873,9167,2626,1825,3173,
4788,YHR035W,4345,4822,9167,2033,2715,4202,
4789,YPR178W,6109,3058,9167,5340,5026,5586,
4790,YGL044C,6336,2833,9169,6103,5232,5384,
4791,YPR055W,4936,4233,9169,2157,1502,2451,
4792,YHR189W,6288,2882,9170,6633,6609,6562,
4793,YMR167W,3573,5598,9171,4463,4278,4929,
4794,YCL063W,3970,5202,9172,5174,4439,5260,
4795,YJL092W,6093,3084,9177,4323,3968,3885,
4796,YJR061W,3522,5656,9178,4048,4321,3977,
4797,YPR158C-D,4033,5145,9178,2352,3031,4618,
4798,YMR283C,3752,5428,9180,3388,3837,5892,
4799,YDR198C,5593,3590,9183,3935,3946,4848,
4800,YLR263W,3893,5292,9185,1807,1652,1695,
4801,YGL155W,4569,4618,9187,5151,4532,5570,
4802,YDL107W,4157,5033,9190,4756,4267,4636,
4803,YIL144W,4246,4944,9190,2788,1498,2650,
4804,YML029W,5738,3454,9192,4875,5233,3808,
4805,YLR357W,3517,5679,9196,2988,2865,2642,
4806,YCR097W,5908,3288,9196,1502,824,2758,
4807,YJL218W,4483,4714,9197,4113,4746,5836,
4808,YGR018C,4486,4712,9198,3437,4602,5818,
4809,YOL060C,5359,3839,9198,3983,5396,2684,
4810,YPR155C,5552,3649,9201,3699,3476,3514,
4811,YER092W,4990,4211,9201,6030,5038,4309,
4812,YLL007C,4741,4462,9203,3694,3315,5140,
4813,YKR005C,5321,3882,9203,3217,3040,4090,
4814,YOR288C,5056,4149,9205,3209,4142,4319,
4815,YDR287W,6326,2880,9206,4076,2572,3445,
4816,YBR184W,3395,5811,9206,3368,2284,5724,
4817,YEL068C,5260,3946,9206,4009,4214,3441,
4818,YLR020C,4798,4409,9207,3225,2351,3985,
4819,YNR049C,5800,3409,9209,6137,5849,5936,
4820,YFL023W,5190,4025,9215,5144,4839,1801,
4821,YDL115C,3078,6137,9215,4480,3178,2935,
4822,YNR007C,5328,3888,9216,3427,2824,3541,
4823,YOR161W-A,3137,6081,9218,6095,6482,5551,
4824,YDL018C,5773,3445,9218,3009,4417,3876,
4825,YLR093C,5168,4051,9219,3927,5495,3532,
4826,YCL007C,5575,3645,9220,3490,4435,4870,
4827,YDR393W,4546,4675,9221,3284,3244,2375,
4828,YAL066W,3724,5500,9224,1970,2137,6387,
4829,YOL028C,5585,3639,9224,5774,5136,2710,
4830,YFL034C-B,3172,6053,9225,5521,4887,3910,
4831,YHR149C,3903,5323,9226,4457,2688,4910,
4832,YDR138W,4485,4741,9226,2268,2641,2537,
4833,YMR179W,3014,6214,9228,4556,3537,5058,
4834,YDL207W,5423,3806,9229,5574,4346,2725,
4835,YDR052C,3971,5259,9230,3064,1861,2065,
4836,YNL058C,5713,3520,9233,1906,2056,2734,
4837,YPR084W,4907,4328,9235,4245,4380,4659,
4838,YHR067W,5655,3581,9236,4737,5294,5737,
4839,YDR017C,5075,4162,9237,3207,2090,2740,
4840,YCR045W-A,5524,3713,9237,6179,6304,6136,
4841,YNL311C,4364,4877,9241,3044,3759,4773,
4842,YMR252C,6251,2990,9241,5313,5732,3762,
4843,YHR172W,5053,4194,9247,2584,2936,3299,
4844,YLR353W,3027,6222,9249,5741,5310,5772,
4845,YDR154C,6369,2887,9256,5218,4252,5352,
4846,YPR081C,3910,5348,9258,4318,3955,3382,
4847,YPL100W,5467,3791,9258,4858,3474,5308,
4848,YOL019W-A,4705,4555,9260,5887,6165,2434,
4849,YHR110W,5570,3690,9260,4273,5538,2790,
4850,YMR166C,6561,2699,9260,5390,4985,4373,
4851,YDL123W,5851,3414,9265,5871,5782,6226,
4852,YKL139W,3540,5726,9266,3683,2676,3694,
4853,YLR416C,3356,5910,9266,5944,6201,5907,
4854,YJR043C,4685,4582,9267,3698,2671,1685,
4855,YHR011W,5085,4184,9269,5843,4969,4752,
4856,YDL073W,3621,5649,9270,2438,1535,4097,
4857,YKL176C,3347,5929,9276,4966,4771,3889,
4858,YDR217C,3878,5398,9276,4132,3356,4790,
4859,YDR535C,5578,3699,9277,6032,6014,6415,
4860,YOR247W,6244,3034,9278,1140,4817,1629,
4861,YDR230W,3892,5387,9279,6279,6093,6460,
4862,YER185W,3905,5375,9280,5050,4392,4744,
4863,YPL132W,4217,5063,9280,2602,1751,4158,
4864,YPL174C,3793,5488,9281,4392,3338,4595,
4865,YDR392W,4260,5021,9281,3953,3802,3419,
4866,YOR355W,4949,4333,9282,2545,1054,3117,
4867,YLR315W,4408,4875,9283,6577,6488,6422,
4868,YGR109W-B,3684,5601,9285,3161,5274,4998,
4869,YLR243W,5098,4189,9287,3335,3484,4263,
4870,YDR402C,4152,5139,9291,3260,3063,4472,
4871,YNL319W,4585,4707,9292,2805,2039,4754,
4872,YHL008C,3669,5624,9293,5075,4491,4877,
4873,YLR364C-A,6416,2877,9293,5864,5625,6015,
4874,YER115C,4947,4346,9293,5329,5089,5479,
4875,YMR036C,2894,6399,9293,4302,3770,5343,
4876,YPR115W,4315,4982,9297,5018,4163,4429,
4877,YLL035W,5041,4257,9298,4669,3595,4779,
4878,YOR214C,4756,4544,9300,4517,2705,4256,
4879,YOL097W-A,4509,4791,9300,4231,4134,5176,
4880,YFL051C,3759,5545,9304,4329,4690,5439,
4881,YOL075C,3619,5687,9306,4141,2228,4104,
4882,YNL266W,5373,3935,9308,4890,4358,3642,
4883,YPR164W,5044,4270,9314,2873,2917,3956,
4884,YCR082W,4758,4557,9315,2914,5110,4298,
4885,YDR445C,4586,4730,9316,5282,4975,5453,
4886,YHR191C,4944,4374,9318,6487,6134,5400,
4887,YBR109W-A,4391,4927,9318,3168,2837,5957,
4888,YGR002C,5163,4158,9321,5135,4475,4291,
4889,YJL056C,5023,4300,9323,1848,1678,3959,
4890,YLR157W-D,4302,5022,9324,5759,6216,4812,
4891,YDR485C,4791,4537,9328,4063,2337,2437,
4892,YMR263W,5356,3981,9337,5802,6101,3486,
4893,YGR213C,4420,4920,9340,4911,3637,3982,
4894,YOR308C,4082,5260,9342,4192,3205,4826,
4895,YLR467W,4515,4828,9343,6142,6221,5719,
4896,YLR207W,5955,3391,9346,3139,3873,2718,
4897,YIL107C,5765,3583,9348,1564,1036,2365,
4898,YOR269W,5835,3516,9351,2741,3307,4962,
4899,YDR416W,4707,4646,9353,3292,1805,4493,
4900,YBR168W,3857,5498,9355,3779,2515,4843,
4901,YBR024W,6309,3047,9356,3025,3869,3276,
4902,YOR025W,3585,5771,9356,5484,5848,4895,
4903,YDR279W,5940,3417,9357,3635,2908,4142,
4904,YNR028W,4273,5089,9362,3211,3560,2670,
4905,YDR015C,4715,4648,9363,4773,5493,5762,
4906,YNL197C,5296,4067,9363,2999,2649,3790,
4907,YNL091W,4498,4866,9364,4224,4027,4239,
4908,YOR047C,3648,5718,9366,3801,2437,3739,
4909,YLR033W,3818,5549,9367,1833,1323,3114,
4910,YDR482C,6409,2959,9368,6677,6670,6625,
4911,YLR371W,4026,5353,9379,2388,1643,3063,
4912,YKL165C-A,2924,6455,9379,6446,6010,6172,
4913,YOL100W,3821,5560,9381,3263,2015,4073,
4914,YOR070C,4868,4514,9382,4355,4650,5705,
4915,YBR296C-A,2831,6552,9383,3301,3168,2804,
4916,YER018C,5107,4277,9384,6659,6673,6149,
4917,YGL248W,5245,4140,9385,4285,5265,4404,
4918,YFL009W,3653,5732,9385,3381,2718,3639,
4919,YBR032W,4138,5247,9385,6384,6251,6454,
4920,YNR037C,4761,4625,9386,6392,6358,3868,
4921,YBR297W,4487,4899,9386,3604,4036,5686,
4922,YIL021C-A,5826,3563,9389,3423,5817,4499,
4923,YCL047C,6070,3319,9389,5512,4952,4441,
4924,YIL058W,6060,3330,9390,3552,4787,5755,
4925,YLR159W,4087,5307,9394,6320,6461,5324,
4926,YBR089W,4735,4659,9394,4782,3158,5226,
4927,YOR201C,4952,4444,9396,5832,5807,4228,
4928,YDR118W-A,5761,3637,9398,4462,4834,5066,
4929,YGL127C,4857,4542,9399,6424,6313,4937,
4930,YML016C,6466,2933,9399,1829,1581,3278,
4931,YER061C,5026,4376,9402,5105,4765,4438,
4932,YCL075W,5744,3659,9403,3692,4903,5238,
4933,YIL131C,6504,2903,9407,4787,4699,4322,
4934,YLR092W,4880,4527,9407,1749,2850,1908,
4935,YJL102W,4438,4969,9407,4259,3291,4081,
4936,YLR236C,5718,3693,9411,6162,6121,6052,
4937,YER087W,4821,4591,9412,3611,2830,4331,
4938,YGR039W,5113,4299,9412,4865,5312,6046,
4939,YFL025C,4819,4594,9413,3106,2748,4328,
4940,YKL106W,5396,4020,9416,2560,2606,3246,
4941,YLR234W,3954,5463,9417,6270,6453,5190,
4942,YIR017C,3943,5475,9418,6547,6558,2973,
4943,YER123W,4797,4621,9418,1394,1073,4076,
4944,YDR203W,5693,3726,9419,6057,5009,6181,
4945,YKL121W,4124,5298,9422,2968,2714,4327,
4946,YJL127C-B,4164,5263,9427,3247,1802,2211,
4947,YPR202W,5443,3987,9430,4252,4987,4431,
4948,YML115C,5368,4066,9434,3144,2806,2082,
4949,YOR172W,3422,6014,9436,4806,4355,4260,
4950,YML104C,5128,4308,9436,3276,2324,4296,
4951,YPL277C,4904,4532,9436,5170,5548,5408,
4952,YLR277C,4514,4924,9438,2216,1553,3205,
4953,YIL060W,4244,5195,9439,5546,5562,6033,
4954,YNR014W,3682,5758,9440,6135,6546,4288,
4955,YLR103C,5612,3829,9441,3693,4094,4172,
4956,YDR108W,4223,5220,9443,3531,2354,4271,
4957,YER028C,3542,5902,9444,5859,5575,6332,
4958,YJR098C,5146,4298,9444,1875,1350,3028,
4959,YLR087C,4130,5317,9447,3672,2955,4307,
4960,YDR306C,3533,5915,9448,4271,2578,5044,
4961,YNL143C,3410,6038,9448,4331,5225,2948,
4962,YPL025C,4671,4778,9449,6276,6387,6252,
4963,YKR004C,4644,4806,9450,2402,1087,5544,
4964,YHL037C,4335,5116,9451,4749,5486,5591,
4965,YHL025W,4886,4567,9453,6494,6511,5572,
4966,YJL043W,4031,5422,9453,6540,6598,5867,
4967,YDL231C,4964,4490,9454,3615,3798,3927,
4968,YDR058C,4590,4867,9457,2245,2617,4221,
4969,YLR080W,4207,5250,9457,4888,4253,4507,
4970,YCR073C,3922,5537,9459,3857,3820,3937,
4971,YPL191C,6565,2896,9461,3061,2098,5193,
4972,YNR069C,3700,5763,9463,5193,4922,4999,
4973,YMR165C,5446,4019,9465,4709,4359,3528,
4974,YEL036C,6545,2921,9466,4208,5993,1890,
4975,YOR073W,3372,6096,9468,3911,3855,3842,
4976,YLR463C,5218,4251,9469,6037,6399,6211,
4977,YGR033C,6603,2866,9469,5023,3835,4207,
4978,YOR008C,4658,4811,9469,6018,5377,5644,
4979,YML009W-B,5909,3562,9471,6683,6666,6660,
4980,YGR021W,6279,3192,9471,6355,6371,4040,
4981,YKR100C,5197,4274,9471,5103,4280,5015,
4982,YAL055W,5309,4163,9472,6116,5479,5857,
4983,YLR451W,5187,4293,9480,4471,3056,5281,
4984,YBR221W-A,6406,3075,9481,6364,6599,6641,
4985,YPR134W,5956,3525,9481,5837,5408,5684,
4986,YDR423C,3914,5568,9482,5708,5537,5592,
4987,YDR282C,5017,4468,9485,5112,5029,5730,
4988,YPR003C,3163,6324,9487,5414,4850,5765,
4989,YAL065C,4496,4991,9487,4715,4970,5108,
4990,YFR019W,4250,5239,9489,3130,3447,3741,
4991,YMR134W,5444,4047,9491,4504,4096,5095,
4992,YCR102W-A,5605,3887,9492,4377,1781,5856,
4993,YDR026C,4777,4720,9497,2095,1937,2091,
4994,YBR250W,4835,4663,9498,2253,1769,3670,
4995,YHR032C-A,5453,4045,9498,6437,5599,4642,
4996,YDR351W,3214,6286,9500,4739,4188,5380,
4997,YDR401W,4545,4956,9501,5428,4494,5796,
4998,YPL040C,4731,4771,9502,3937,4023,3944,
4999,YFR003C,6518,2984,9502,5386,4939,5617,
5000,YGL085W,3852,5653,9505,3014,3114,5727,
5001,YPR025C,4166,5342,9508,4422,2147,2950,
5002,YKR067W,5581,3927,9508,2234,3453,2281,
5003,YJL199C,5157,4359,9516,6224,6341,5961,
5004,YBL046W,5223,4295,9518,4470,5081,3002,
5005,YDR313C,5120,4400,9520,5250,4336,5605,
5006,YPL163C,5711,3816,9527,1281,1705,1694,
5007,YGL107C,4158,5370,9528,3085,3811,2955,
5008,YDR459C,5823,3707,9530,4584,4965,6010,
5009,YGR131W,6530,3005,9535,5257,3412,5764,
5010,YKR063C,3839,5699,9538,4333,2591,5107,
5011,YIL122W,3520,6019,9539,6405,5854,6441,
5012,YBL085W,5348,4191,9539,4155,3305,3315,
5013,YGL229C,4191,5349,9540,1412,1592,2336,
5014,YAL033W,5182,4362,9544,6354,6420,6263,
5015,YDR251W,5147,4398,9545,3407,2596,4274,
5016,YMR127C,4548,4998,9546,5598,5085,5736,
5017,YML122C,3586,5961,9547,6404,6509,6063,
5018,YJL181W,4547,5003,9550,4567,4753,5224,
5019,YNL100W,6094,3457,9551,5493,4327,5061,
5020,YMR185W,3962,5591,9553,1910,1766,3286,
5021,YDR239C,5542,4013,9555,4804,4250,4938,
5022,YLR085C,4774,4784,9558,5439,5078,5816,
5023,YDR442W,6344,3216,9560,6583,6145,6432,
5024,YDR438W,4682,4880,9562,5275,4592,5874,
5025,YNL005C,5202,4361,9563,4226,3609,2159,
5026,YKR021W,3543,6021,9564,3816,3646,4797,
5027,YBR206W,4927,4637,9564,6189,5602,6081,
5028,YHR120W,5344,4222,9566,4916,3252,4647,
5029,YKL020C,3650,5921,9571,2404,4486,3123,
5030,YLR177W,4403,5170,9573,5447,5805,2679,
5031,YGL211W,5844,3729,9573,5930,5615,3599,
5032,YOL007C,4911,4664,9575,2432,2923,5069,
5033,YGL140C,5126,4452,9578,4147,3082,3870,
5034,YPL060W,4973,4605,9578,4390,4773,5879,
5035,YBR290W,5687,3894,9581,4823,3518,4825,
5036,YBL084C,3307,6275,9582,4614,2475,4699,
5037,YNL278W,5632,3951,9583,4493,4742,3893,
5038,YOR324C,3946,5638,9584,5506,5217,4411,
5039,YGL141W,4697,4889,9586,2364,2352,2752,
5040,YML041C,4008,5579,9587,5622,4844,5969,
5041,YJR059W,5377,4213,9590,2969,4028,2117,
5042,YOL115W,5478,4113,9591,2750,2712,3918,
5043,YKL079W,5963,3630,9593,4372,3830,3626,
5044,YGR215W,5249,4345,9594,5472,5236,4649,
5045,YPL279C,5859,3736,9595,2013,1924,2612,
5046,YIL031W,3831,5766,9597,2206,1247,3578,
5047,YPL082C,5123,4474,9597,3456,2758,2793,
5048,YML101C,6047,3552,9599,6564,6523,6154,
5049,YLR298C,4834,4765,9599,4548,5050,3442,
5050,YOL095C,5166,4435,9601,3680,2818,3788,
5051,YHR070W,4971,4630,9601,5572,6322,3260,
5052,YBR186W,3531,6071,9602,5830,5249,5139,
5053,YJL106W,3441,6161,9602,2010,905,3094,
5054,YNR048W,5415,4188,9603,4724,4918,4217,
5055,YOR066W,5102,4502,9604,4885,4693,4276,
5056,YLR280C,4719,4885,9604,6682,6684,6533,
5057,YOL116W,5256,4350,9606,5595,5043,5372,
5058,YBR268W,6308,3299,9607,6502,6490,6240,
5059,YDR206W,4906,4702,9608,4345,3348,4293,
5060,YLR079W,4294,5315,9609,5942,5127,4783,
5061,YBL029W,3408,6203,9611,4950,4556,5427,
5062,YJL077W-A,6201,3413,9614,5842,6209,3798,
5063,YBL059W,4358,5265,9623,5652,5212,5955,
5064,YCR081W,4232,5392,9624,1812,2369,2887,
5065,YML114C,4688,4936,9624,5638,5747,4580,
5066,YPL041C,3446,6179,9625,6094,5926,5921,
5067,YJL061W,5206,4421,9627,1904,2182,2995,
5068,YML023C,5384,4244,9628,5719,4399,5560,
5069,YGL183C,6194,3437,9631,5529,4238,2096,
5070,YMR061W,4699,4932,9631,2168,1585,2499,
5071,YNL177C,5341,4294,9635,5192,3695,3695,
5072,YPL096W,5676,3963,9639,5062,4353,4673,
5073,YMR247W-A,5840,3802,9642,4059,5994,6446,
5074,YDL159W,4401,5241,9642,5029,4108,4555,
5075,YIL006W,3875,5768,9643,6339,6238,5970,
5076,YOL042W,5280,4365,9645,3154,2662,3978,
5077,YNL235C,5087,4559,9646,4961,4040,6406,
5078,YLR107W,4957,4694,9651,3776,3603,3923,
5079,YJL084C,3679,5972,9651,3507,2417,3957,
5080,YLR269C,4864,4788,9652,5415,4402,6267,
5081,YIL087C,6405,3250,9655,5865,5750,3964,
5082,YFL040W,5657,3998,9655,4898,4361,4460,
5083,YEL075W-A,5369,4287,9656,6131,6411,6309,
5084,YNL114C,4894,4768,9662,2082,6019,6395,
5085,YER171W,4504,5158,9662,2320,1376,2666,
5086,YMR228W,4615,5050,9665,2314,1012,3498,
5087,YOR218C,4477,5188,9665,953,5582,4858,
5088,YOR307C,5479,4187,9666,4406,4642,5135,
5089,YMR207C,4286,5380,9666,4413,3530,3616,
5090,YLR427W,5511,4156,9667,4029,4779,3605,
5091,YHL045W,3515,6157,9672,3356,2019,4845,
5092,YKL220C,3937,5736,9673,4253,2667,4907,
5093,YNL275W,3850,5826,9676,5615,4791,5628,
5094,YJR151C,4266,5411,9677,851,1207,1714,
5095,YOL073C,4626,5054,9680,6225,5942,6185,
5096,YLR161W,4341,5340,9681,6322,6460,5323,
5097,YML081W,4594,5087,9681,2886,2490,3664,
5098,YDR414C,4666,5019,9685,4430,4469,5442,
5099,YGL045W,4476,5211,9687,5479,5585,3930,
5100,YLR412W,4213,5476,9689,4714,3469,5161,
5101,YBR129C,4745,4954,9699,2303,2361,3835,
5102,YPR198W,3720,5980,9700,5183,3796,5342,
5103,YHR214C-D,5529,4171,9700,4354,5064,6298,
5104,YGL063C-A,3674,6028,9702,6676,6660,6281,
5105,YDR030C,3613,6089,9702,3462,2553,5435,
5106,YDR322W,4554,5149,9703,2101,2506,3468,
5107,YJL127C,3760,5945,9705,4972,4901,5048,
5108,YMR013C,4673,5032,9705,4779,4308,5690,
5109,YDR151C,3997,5713,9710,4305,3074,4626,
5110,YGR212W,4268,5443,9711,3031,2886,5392,
5111,YDR275W,4793,4918,9711,4805,4938,5043,
5112,YDR509W,3978,5734,9712,1549,4256,5160,
5113,YDR197W,4077,5637,9714,3951,3376,5518,
5114,YDR187C,3231,6483,9714,6380,6410,6253,
5115,YLR331C,5872,3842,9714,6005,5832,4435,
5116,YDL241W,3451,6263,9714,5793,3428,5717,
5117,YDL037C,3757,5957,9714,680,455,1431,
5118,YKL052C,4224,5490,9714,6336,6220,5398,
5119,YBR178W,3427,6289,9716,6173,5830,6291,
5120,YEL077C,4447,5270,9717,6100,6211,5517,
5121,YGL177W,3886,5834,9720,5299,4307,6264,
5122,YGL197W,4503,5219,9722,4366,3942,4576,
5123,YJL134W,6038,3685,9723,5422,5181,5740,
5124,YPR138C,4933,4790,9723,2431,1743,3012,
5125,YHL017W,5400,4331,9731,2780,3523,2821,
5126,YNL019C,5557,4179,9736,6088,6222,5386,
5127,YMR219W,5276,4460,9736,3167,2746,2711,
5128,YPL268W,4681,5059,9740,3195,1521,3221,
5129,YDR422C,4150,5595,9745,3628,2640,4356,
5130,YNL165W,5445,4302,9747,5728,5610,5850,
5131,YMR081C,5437,4310,9747,3401,3960,5452,
5132,YER114C,5554,4196,9750,4513,4317,3282,
5133,YBR232C,5547,4205,9752,6507,6039,6147,
5134,YMR106C,6036,3717,9753,4928,4609,3518,
5135,YLR127C,3538,6215,9753,3216,2422,5021,
5136,YFR013W,3527,6229,9756,3315,2586,3485,
5137,YPL035C,4656,5101,9757,2588,3003,6431,
5138,YKL132C,6140,3617,9757,5295,5365,5580,
5139,YHL019W-A,4392,5367,9759,6444,6401,5810,
5140,YLR350W,5454,4307,9761,5884,6437,5137,
5141,YGL124C,6284,3479,9763,4910,3800,4509,
5142,YMR176W,3765,5999,9764,3561,2831,3940,
5143,YOR390W,5895,3874,9769,1951,1829,2629,
5144,YER068C-A,6341,3429,9770,5700,4095,6164,
5145,YHR056C,5108,4662,9770,1926,1724,3107,
5146,YIL090W,5925,3848,9773,3949,3429,5252,
5147,YNL027W,5645,4129,9774,2226,2562,3546,
5148,YLR404W,5863,3913,9776,4784,4594,4625,
5149,YOR129C,4211,5567,9778,3750,3694,4670,
5150,YBL048W,4370,5409,9779,1343,867,5594,
5151,YLR239C,6449,3331,9780,3358,2680,2835,
5152,YAR029W,4388,5394,9782,4010,3573,4015,
5153,YAL032C,5688,4094,9782,5141,5577,2637,
5154,YBR013C,5388,4394,9782,4661,1160,6159,
5155,YDR144C,4154,5629,9783,3021,2891,2974,
5156,YKL194C,5164,4620,9784,1678,2496,1746,
5157,YPR007C,4003,5786,9789,2985,3235,3666,
5158,YEL008W,3776,6020,9796,5989,6025,5980,
5159,YBL012C,3633,6164,9797,6463,6526,6554,
5160,YDR317W,4424,5374,9798,2674,1215,3004,
5161,YMR194C-B,5100,4699,9799,6469,6295,6553,
5162,YMR066W,4497,5311,9808,3984,2793,4250,
5163,YOR140W,4443,5365,9808,5059,5584,3861,
5164,YLL049W,5634,4175,9809,4336,5176,4545,
5165,YPR053C,4291,5520,9811,6594,6244,6271,
5166,YPR049C,4916,4898,9814,3823,2737,4261,
5167,YGR242W,5177,4638,9815,6358,6486,6477,
5168,YBL063W,5430,4387,9817,2963,3177,3016,
5169,YGR143W,4144,5673,9817,2457,2178,3983,
5170,YER067C-A,4563,5255,9818,5444,6253,6546,
5171,YKR055W,5893,3926,9819,5463,4348,5985,
5172,YKL134C,4696,5124,9820,3007,2414,4140,
5173,YDR137W,5005,4816,9821,4785,3206,4849,
5174,YDR463W,4796,5025,9821,3633,4644,2557,
5175,YDR147W,5469,4355,9824,2617,1448,3412,
5176,YGR068C,4677,5147,9824,6039,6266,5486,
5177,YLR156W,4305,5519,9824,6321,6459,5330,
5178,YDL093W,6168,3658,9826,2295,2067,3222,
5179,YLR431C,5741,4086,9827,5760,5506,4806,
5180,YAL019W,6260,3568,9828,3051,3592,1657,
5181,YLR227C,4118,5710,9828,2772,1219,4324,
5182,YBR028C,5736,4093,9829,2784,2754,2816,
5183,YBR066C,3554,6278,9832,4538,2948,5201,
5184,YOR213C,3799,6033,9832,5813,5306,5403,
5185,YJL063C,6364,3472,9836,6552,6492,4874,
5186,YMR181C,5590,4250,9840,1679,5197,2838,
5187,YPL241C,6289,3555,9844,4578,5282,5505,
5188,YBL037W,4945,4900,9845,3709,3295,3077,
5189,YBR254C,4574,5274,9848,5364,5001,5096,
5190,YER107W-A,4754,5095,9849,3624,1749,5731,
5191,YJL193W,3859,5990,9849,5443,3863,5091,
5192,YKL049C,5894,3956,9850,5406,4271,3960,
5193,YER045C,3980,5870,9850,2086,3231,3896,
5194,YJL059W,5892,3958,9850,3524,2807,5331,
5195,YMR037C,4206,5647,9853,2751,3729,5183,
5196,YCR096C,5340,4513,9853,5545,5552,5606,
5197,YDL183C,5419,4443,9862,5583,4932,5863,
5198,YMR132C,4872,4993,9865,2906,1651,3553,
5199,YNL258C,5797,4068,9865,2681,2174,3101,
5200,YLR373C,5723,4142,9865,2504,3884,3054,
5201,YCL008C,3996,5871,9867,6205,6419,5871,
5202,YDL189W,5725,4144,9869,4515,4578,5507,
5203,YDL170W,5355,4518,9873,4753,5287,4215,
5204,YCR095C,3694,6180,9874,4762,1620,4038,
5205,YGL162W,4369,5506,9875,4864,5774,4487,
5206,YPR120C,4129,5752,9881,3411,3125,2754,
5207,YPL247C,5094,4789,9883,6150,6146,5275,
5208,YDR179C,5207,4677,9884,4822,2259,5691,
5209,YAL063C-A,4433,5451,9884,791,312,1373,
5210,YHR116W,5289,4596,9885,6059,6499,5293,
5211,YNL328C,5025,4861,9886,5985,6190,3722,
5212,YOR192C-C,3426,6460,9886,709,115,3874,
5213,YJR012C,5937,3949,9886,4399,2540,4359,
5214,YJL208C,4915,4973,9888,3706,1894,3628,
5215,YML097C,4840,5051,9891,3999,4041,2945,
5216,YBL100C,4434,5458,9892,6399,5515,6599,
5217,YER149C,5928,3964,9892,5004,5062,4450,
5218,YMR201C,6470,3424,9894,4213,3828,3871,
5219,YAR069C,5337,4558,9895,4348,5073,6297,
5220,YNL033W,5643,4252,9895,6097,6218,5432,
5221,YHL006C,5418,4477,9895,6658,6664,6568,
5222,YEL062W,4200,5696,9896,2964,2331,4304,
5223,YER106W,5045,4852,9897,2171,1479,4672,
5224,YER091C-A,5675,4224,9899,6639,6512,6358,
5225,YPL068C,3871,6029,9900,5679,5415,5328,
5226,YPR022C,4225,5675,9900,3530,3045,4369,
5227,YNL326C,5841,4061,9902,4607,3044,5855,
5228,YJR019C,5869,4034,9903,6351,6555,5447,
5229,YHR151C,4097,5807,9904,4344,4066,5470,
5230,YBR156C,4085,5819,9904,4016,2814,4157,
5231,YCL036W,4135,5776,9911,6388,6359,5333,
5232,YAR008W,5599,4313,9912,4455,4533,3398,
5233,YMR065W,3842,6072,9914,3736,3107,5053,
5234,YER088W-B,4292,5622,9914,6609,6530,5571,
5235,YBL096C,3866,6051,9917,6210,6291,6275,
5236,YOR093C,4739,5179,9918,2656,1630,3915,
5237,YPL075W,3378,6542,9920,5461,4084,5655,
5238,YMR232W,4651,5273,9924,3033,2087,4766,
5239,YDL032W,6275,3650,9925,5526,6031,5983,
5240,YOR242C,4661,5266,9927,3849,1244,3254,
5241,YLR171W,5762,4166,9928,3864,4686,5749,
5242,YMR160W,4382,5548,9930,3645,3163,5174,
5243,YPL038W,6577,3357,9934,6212,5958,6207,
5244,YHR165C,4792,5144,9936,2218,1959,3131,
5245,YBR269C,5492,4445,9937,6490,6423,6005,
5246,YLR213C,4655,5283,9938,5739,5333,3767,
5247,YHR118C,5466,4475,9941,3567,2188,2877,
5248,YDR118W,3841,6102,9943,4481,3347,5243,
5249,YGL257C,6145,3801,9946,4629,3531,4571,
5250,YKL023C-A,5748,4198,9946,5571,5353,4303,
5251,YIR005W,6184,3765,9949,3766,2635,5524,
5252,YOR082C,5404,4545,9949,1735,4558,6391,
5253,YIL047C-A,4373,5577,9950,6517,6429,6487,
5254,YJL141C,5013,4940,9953,4381,4377,4836,
5255,YNL011C,5911,4042,9953,3125,1872,3456,
5256,YDR327W,5943,4011,9954,5979,6466,6205,
5257,YCR011C,5664,4290,9954,3343,2691,4394,
5258,YFR040W,4631,5324,9955,1933,3054,2643,
5259,YLR241W,3755,6201,9956,5360,4671,5166,
5260,YLR307W,5698,4260,9958,4110,2558,3850,
5261,YML084W,4173,5787,9960,2391,1993,6450,
5262,YOR329W-A,3512,6448,9960,3643,3938,6294,
5263,YCL001W-B,5154,4807,9961,5943,5526,5046,
5264,YHL036W,4490,5472,9962,5124,4169,4495,
5265,YJL058C,5134,4831,9965,3667,3184,5332,
5266,YHR003C,5527,4440,9967,4272,4210,3687,
5267,YKR096W,5250,4719,9969,3034,3713,3705,
5268,YNL219C,5084,4886,9970,1635,1097,2834,
5269,YJL165C,4147,5824,9971,3807,2848,3462,
5270,YNL279W,6299,3674,9973,5612,5795,5367,
5271,YGL128C,5572,4401,9973,4541,6087,4586,
5272,YOR296W,4729,5254,9983,4353,3403,5241,
5273,YGR198W,5488,4496,9984,3514,2823,3444,
5274,YCR039C,5316,4669,9985,4790,4717,4468,
5275,YJR005W,4706,5280,9986,3638,2499,2260,
5276,YKL147C,6424,3565,9989,6389,6353,6324,
5277,YMR075W,5132,4860,9992,1337,1332,2997,
5278,YNL106C,4412,5582,9994,4335,3564,4530,
5279,YOR350C,4803,5193,9996,3602,2772,4607,
5280,YML107C,4929,5068,9997,4770,4682,5261,
5281,YIR030W-A,6236,3762,9998,5269,3726,6072,
5282,YNL097W-A,6665,3336,10001,5935,6611,6642,
5283,YML002W,4235,5767,10002,3312,2867,4383,
5284,YOL114C,5000,5005,10005,4234,4662,4465,
5285,YDR270W,6105,3902,10007,3578,2950,2699,
5286,YIL158W,5234,4774,10008,5716,5360,4350,
5287,YDR448W,4610,5400,10010,5336,4894,4079,
5288,YKR102W,4072,5938,10010,2694,3300,3529,
5289,YPR130C,6181,3831,10012,3236,5177,5770,
5290,YHR213W-A,3662,6352,10014,6260,6043,6125,
5291,YMR030W,4459,5556,10015,2646,3423,4074,
5292,YMR063W,6123,3892,10015,5910,5696,5382,
5293,YIL156W-B,5801,4218,10019,6479,6404,4911,
5294,YPL066W,4105,5918,10023,4015,5349,4772,
5295,YPL259C,5969,4056,10025,2975,1475,3195,
5296,YML059C,6112,3916,10028,2114,2825,2269,
5297,YPL242C,5618,4411,10029,3618,2522,3866,
5298,YNR062C,5183,4850,10033,5896,5057,5202,
5299,YDL185C-A,4747,5290,10037,2294,2050,6086,
5300,YIL056W,5891,4146,10037,3697,4831,3679,
5301,YLR360W,4750,5287,10037,3980,3908,4930,
5302,YNL296W,5288,4750,10038,6306,6260,6630,
5303,YPR018W,5839,4202,10041,3622,3598,2363,
5304,YOL063C,5968,4075,10043,3977,4244,4637,
5305,YCR026C,5597,4450,10047,4332,4374,4414,
5306,YJR084W,6254,3795,10049,5980,6056,6073,
5307,YGL114W,6154,3899,10053,5710,5410,5223,
5308,YNL092W,5171,4882,10053,5205,5132,5269,
5309,YBR099C,5936,4117,10053,1634,1242,5930,
5310,YCL023C,4692,5362,10054,4167,6231,6054,
5311,YML099C,4061,5993,10054,3520,2685,3803,
5312,YJR066W,5978,4080,10058,3329,2538,3473,
5313,YGL074C,5906,4153,10059,6555,6265,6605,
5314,YBL070C,5431,4631,10062,5210,5178,6359,
5315,YMR194C-A,5473,4599,10072,6061,5992,6278,
5316,YPL238C,3593,6481,10074,6253,5092,5613,
5317,YLL067C,4782,5294,10076,6160,6297,5525,
5318,YBR123C,5462,4615,10077,3111,2644,2535,
5319,YGR168C,5267,4810,10077,3074,3198,3658,
5320,YML065W,4683,5396,10079,3114,1664,2206,
5321,YOR001W,5539,4543,10082,4437,3080,4523,
5322,YGL239C,5755,4327,10082,6177,5199,6122,
5323,YLL016W,6086,3997,10083,2861,2881,2550,
5324,YOL047C,3968,6118,10086,6127,6017,5991,
5325,YHR081W,5918,4169,10087,5715,4577,2878,
5326,YAR014C,5336,4759,10095,5505,4825,4388,
5327,YKR036C,4701,5395,10096,4664,4266,4400,
5328,YJR113C,6155,3942,10097,6522,6491,3724,
5329,YCR071C,5351,4746,10097,5828,5358,4181,
5330,YJR011C,6083,4014,10097,2441,2359,3656,
5331,YLR023C,4557,5541,10098,2035,1923,2634,
5332,YDR455C,6249,3849,10098,5632,4893,5595,
5333,YGR122C-A,6549,3550,10099,744,546,1792,
5334,YOR022C,4958,5142,10100,2768,2116,3104,
5335,YMR172W,3870,6235,10105,5297,5297,5121,
5336,YCR040W,4624,5485,10109,4959,4165,5845,
5337,YDR244W,6393,3718,10111,4647,3432,3341,
5338,YOR300W,3598,6514,10112,5478,5256,5274,
5339,YDR379W,4309,5806,10115,5125,3807,4941,
5340,YJL112W,5771,4344,10115,4734,3987,4622,
5341,YMR187C,4303,5813,10116,3843,3778,5925,
5342,YJL154C,4771,5350,10121,2982,4010,3783,
5343,YLR154W-C,3985,6136,10121,3587,6011,5443,
5344,YNL004W,5020,5103,10123,3045,4836,4190,
5345,YOR223W,4442,5682,10124,6363,6246,4506,
5346,YDR334W,4516,5609,10125,3002,1984,2741,
5347,YDR323C,5059,5069,10128,3837,3891,5018,
5348,YNL164C,4520,5610,10130,3957,4022,5019,
5349,YLR365W,4251,5879,10130,5836,5619,5882,
5350,YHR007C-A,5049,5083,10132,5416,5601,5760,
5351,YPR196W,5301,4838,10139,3902,5042,6109,
5352,YOR104W,4884,5257,10141,3850,2716,5023,
5353,YPR195C,5262,4881,10143,6641,6347,6248,
5354,YBR235W,5876,4269,10145,4367,3197,3898,
5355,YLR037C,5625,4526,10151,168,123,212,
5356,YOR322C,5300,4854,10154,5194,4758,5381,
5357,YOR037W,5097,5058,10155,4981,4721,5490,
5358,YBR225W,5360,4796,10156,2907,2486,3313,
5359,YFR029W,4618,5538,10156,5752,6250,5182,
5360,YLR403W,4992,5165,10157,1177,805,2938,
5361,YOR249C,4755,5404,10159,2937,2457,5204,
5362,YER039C-A,4120,6039,10159,6066,5977,5974,
5363,YPR157W,6235,3924,10159,3475,4389,3873,
5364,YER029C,5297,4863,10160,6427,5803,4598,
5365,YKL133C,4691,5471,10162,3133,3739,3820,
5366,YHR086W,5852,4311,10163,3732,3331,3659,
5367,YOR343C,4893,5272,10165,6664,6657,6659,
5368,YOR384W,3865,6308,10173,6111,5741,6225,
5369,YGR217W,4126,6048,10174,4642,3656,5029,
5370,YGR073C,5622,4553,10175,4145,4652,6108,
5371,YER133W-A,3761,6415,10176,4949,5379,6574,
5372,YGR146C,4764,5413,10177,2520,3934,3872,
5373,YLR112W,5151,5026,10177,6436,6073,6636,
5374,YML116W,5198,4979,10177,5318,3832,5050,
5375,YDR176W,5054,5123,10177,3825,2895,2676,
5376,YGR115C,6189,3993,10182,5403,4242,6044,
5377,YFR028C,5426,4756,10182,4582,5031,3746,
5378,YHR002W,4383,5804,10187,5165,2041,5750,
5379,YLR057W,4155,6032,10187,3543,4237,4338,
5380,YHR079C,4344,5844,10188,4439,3513,5385,
5381,YLR358C,4057,6132,10189,5970,5569,5420,
5382,YGR233C,5433,4757,10190,3221,2412,3618,
5383,YJL119C,5058,5135,10193,5153,5632,5829,
5384,YML082W,6395,3799,10194,6024,5936,3816,
5385,YDL220C,4981,5213,10194,6151,6258,5558,
5386,YNL080C,5345,4855,10200,5688,5875,6104,
5387,YPL176C,5579,4627,10206,5372,5322,4402,
5388,YKL068W,4878,5329,10207,5171,3977,5026,
5389,YGR250C,6092,4116,10208,2132,2393,3141,
5390,YCL066W,4622,5586,10208,4958,4161,5847,
5391,YMR171C,4241,5967,10208,3969,4127,3979,
5392,YGL064C,4607,5602,10209,4126,4465,3770,
5393,YLR405W,6465,3745,10210,5091,5192,4880,
5394,YOR233W,3948,6262,10210,4968,4473,4433,
5395,YMR310C,6220,3992,10212,5909,5929,5265,
5396,YLR014C,4567,5646,10213,4745,3923,5334,
5397,YIL014W,6313,3900,10213,2855,1961,3795,
5398,YJL065C,4238,5977,10215,6113,5968,4979,
5399,YOR030W,3991,6226,10217,2000,2451,5031,
5400,YOR291W,6468,3749,10217,3296,2656,4200,
5401,YJR112W,4517,5703,10220,6527,6577,5715,
5402,YEL073C,4708,5512,10220,4070,2201,4240,
5403,YER147C-A,6128,4098,10226,5915,4688,6040,
5404,YML089C,4593,5635,10228,6458,6540,6457,
5405,YGL215W,4652,5576,10228,1385,1188,3727,
5406,YMR006C,4738,5491,10229,955,1138,1461,
5407,YCR100C,4780,5449,10229,4154,3191,4692,
5408,YPR170C,5104,5126,10230,5488,3649,5886,
5409,YNR023W,4327,5911,10238,4258,3870,5338,
5410,YDL139C,5783,4456,10239,4843,5902,4363,
5411,YGR046W,5270,4971,10241,4304,4012,4405,
5412,YDR301W,5815,4426,10241,1960,2077,2287,
5413,YDR359C,4900,5343,10243,5046,3823,4122,
5414,YDR271C,5455,4792,10247,3595,4150,4558,
5415,YOR372C,4025,6223,10248,5227,3150,4857,
5416,YPL189C-A,5086,5163,10249,5034,3470,4127,
5417,YLR437C-A,5983,4267,10250,6598,6590,6502,
5418,YOR392W,5486,4767,10253,4934,5227,6048,
5419,YPR158W,5606,4650,10256,4535,5207,5200,
5420,YMR281W,5482,4775,10257,1695,3061,3531,
5421,YCR025C,6245,4017,10262,6521,6337,6456,
5422,YNL144C,3774,6490,10264,4138,4639,4262,
5423,YOL032W,6505,3760,10265,6026,5308,6099,
5424,YLR457C,4687,5578,10265,5389,4796,5177,
5425,YOR351C,5398,4870,10268,2465,2485,4192,
5426,YPL248C,4938,5336,10274,5357,4942,5700,
5427,YLR428C,5319,4955,10274,5417,4856,6346,
5428,YLL004W,4202,6075,10277,3124,3596,4572,
5429,YGR068W-A,6176,4102,10278,6006,6204,6366,
5430,YKL033W,4978,5302,10280,4129,2349,4155,
5431,YER088C,5257,5024,10281,3126,5455,2631,
5432,YCR047W-A,4937,5345,10282,5765,6508,4727,
5433,YLR102C,3963,6320,10283,6278,6114,5940,
5434,YMR118C,5268,5018,10286,4985,4807,4267,
5435,YAR003W,6008,4279,10287,3794,3847,5480,
5436,YGL163C,6064,4225,10289,2820,3601,3057,
5437,YKL198C,4604,5688,10292,6169,6588,4578,
5438,YPL193W,5468,4825,10293,3678,1272,4297,
5439,YJL184W,6626,3668,10294,6580,6435,4485,
5440,YMR198W,4378,5916,10294,4585,4816,3629,
5441,YLR039C,4928,5366,10294,1965,1571,3251,
5442,YOL118C,5587,4709,10296,3899,5222,3593,
5443,YPR008W,5644,4652,10296,3555,3371,4761,
5444,YIL140W,5103,5197,10300,2347,2763,2302,
5445,YMR026C,5610,4690,10300,6014,4997,5638,
5446,YHL035C,4342,5959,10301,2696,2303,3624,
5447,YJL211C,4035,6269,10304,6396,6531,6458,
5448,YBR226C,6132,4173,10305,5011,3901,6283,
5449,YPL269W,4274,6031,10305,4137,3582,3369,
5450,YOR342C,5576,4734,10310,2604,4971,3308,
5451,YAL028W,4228,6084,10312,5649,5450,4864,
5452,YMR307C-A,6291,4022,10313,5323,3390,3945,
5453,YDL101C,6166,4147,10313,2565,3311,3162,
5454,YLR390W,5832,4487,10319,4857,5280,4169,
5455,YIL147C,6540,3786,10326,3700,2357,3865,
5456,YBR091C,5324,5004,10328,6626,6487,6614,
5457,YCL067C,5621,4710,10331,4788,4718,4464,
5458,YMR013C-A,5019,5312,10331,6027,5432,6528,
5459,YGR189C,5976,4356,10332,771,1016,1163,
5460,YPR122W,4109,6227,10336,5393,4678,5345,
5461,YDR404C,5217,5120,10337,2844,3467,5249,
5462,YML007W,4807,5530,10337,2427,2322,2969,
5463,YHR211W,6073,4266,10339,838,1047,1042,
5464,YNL140C,4010,6329,10339,6280,6247,5694,
5465,YGL007W,4500,5839,10339,6621,6450,6485,
5466,YHR202W,4559,5780,10339,3266,4007,3484,
5467,YPR047W,5857,4482,10339,2619,3075,2523,
5468,YNL299W,4997,5347,10344,3835,4792,3394,
5469,YIR023W,5781,4563,10344,4228,3314,4894,
5470,YDL033C,5913,4431,10344,5777,6060,5290,
5471,YML034C-A,5518,4827,10345,6462,6524,6373,
5472,YJR035W,5648,4697,10345,4846,4249,3597,
5473,YOR368W,4654,5692,10346,5570,4368,5411,
5474,YFL067W,3874,6476,10350,3708,6152,5186,
5475,YBR293W,4310,6042,10352,5771,5040,6190,
5476,YBR068C,5367,4986,10353,2192,2264,1848,
5477,YGR062C,5063,5291,10354,6477,5999,6505,
5478,YMR272W-B,5411,4943,10354,4140,5754,6151,
5479,YDR503C,6179,4176,10355,4255,5226,4696,
5480,YPL076W,4542,5815,10357,2275,2271,3661,
5481,YNL211C,4406,5952,10358,1805,1433,5312,
5482,YNL314W,5882,4476,10358,6327,6141,6265,
5483,YIL017C,5584,4776,10360,4943,3920,4437,
5484,YDR520C,6126,4238,10364,4349,3358,4951,
5485,YPL149W,6296,4070,10366,4108,4449,5891,
5486,YPL167C,4114,6257,10371,3082,1995,4714,
5487,YPL103C,5864,4512,10376,4913,4502,4798,
5488,YML077W,5750,4628,10378,4060,4133,4380,
5489,YAL034C-B,6526,3854,10380,4195,1607,4227,
5490,YNL057W,6265,4118,10383,6352,5258,4820,
5491,YOR097C,5796,4595,10391,5747,3610,5948,
5492,YOL089C,5907,4486,10393,2625,2046,4360,
5493,YPL072W,6316,4081,10397,3965,4021,4399,
5494,YIL151C,5595,4803,10398,2066,1408,3245,
5495,YDR069C,4255,6144,10399,1821,1309,4012,
5496,YLL038C,5185,5215,10400,6558,6595,6420,
5497,YDL127W,4633,5770,10403,4179,4989,3740,
5498,YDR419W,5389,5015,10404,5337,4325,4686,
5499,YHR102W,4407,6001,10408,5051,4616,5039,
5500,YLL003W,4148,6261,10409,4990,4332,4724,
5501,YOR225W,5555,4856,10411,3586,4658,5714,
5502,YAR035W,5727,4685,10412,6623,6678,4310,
5503,YGR112W,4713,5700,10413,4741,4871,4203,
5504,YDL017W,5778,4635,10413,3650,3062,3972,
5505,YOR064C,5374,5044,10418,5852,5300,5217,
5506,YOR376W,4595,5828,10423,6228,6092,5675,
5507,YBR090C,4649,5775,10424,6491,5897,5189,
5508,YKL115C,4931,5495,10426,4561,4104,6219,
5509,YNL282W,4591,5838,10429,6461,6406,5194,
5510,YIL025C,4968,5464,10432,4089,3768,5515,
5511,YGR134W,4833,5600,10433,4509,3821,4393,
5512,YCL024W,5010,5427,10437,5527,5464,4928,
5513,YDR263C,4414,6024,10438,3767,1696,3509,
5514,YBR210W,6071,4367,10438,5136,4454,5763,
5515,YKL208W,6264,4174,10438,5446,6150,5703,
5516,YJR147W,4564,5877,10441,5963,6431,5414,
5517,YBR182C,4830,5612,10442,5063,4507,5402,
5518,YBR240C,4609,5833,10442,6067,6277,5654,
5519,YMR213W,4980,5466,10446,5764,5534,3508,
5520,YPR171W,5124,5327,10451,5293,4582,4799,
5521,YDR131C,5224,5231,10455,3422,3822,5197,
5522,YER190W,4589,5868,10457,6196,6259,5885,
5523,YHR091C,4832,5625,10457,5274,5305,4490,
5524,YIL086C,5448,5012,10460,3077,5193,4680,
5525,YAL058W,5854,4606,10460,5603,5531,5228,
5526,YLR235C,6532,3932,10464,6651,6659,6612,
5527,YLR151C,6490,3975,10465,4056,3701,4893,
5528,YDR227W,4765,5709,10474,3461,2294,3901,
5529,YLR214W,5528,4949,10477,2039,1559,4760,
5530,YMR119W-A,6098,4380,10478,5280,2619,5615,
5531,YLL066W-B,6588,3893,10481,1254,6299,5699,
5532,YDR006C,5525,4958,10483,2283,1905,2485,
5533,YKL175W,5545,4939,10484,3881,4407,4357,
5534,YLR261C,4845,5639,10484,6537,5964,6020,
5535,YPR005C,4664,5821,10485,5123,3935,5205,
5536,YNL271C,5880,4607,10487,3570,2360,2442,
5537,YPL200W,5451,5036,10487,5564,2959,5673,
5538,YIR016W,4965,5523,10488,6497,6565,6353,
5539,YPR094W,5441,5047,10488,5453,4429,5973,
5540,YFL013W-A,6118,4370,10488,5055,5685,4749,
5541,YGR270C-A,4361,6128,10489,1239,5945,4985,
5542,YOR333C,5449,5042,10491,5766,5727,5114,
5543,YGR179C,5258,5235,10493,4778,4636,5180,
5544,YGL126W,6234,4262,10496,6616,6645,6223,
5545,YJL139C,4436,6060,10496,2943,3992,4376,
5546,YLR383W,5450,5048,10498,3374,2339,2050,
5547,YPR099C,5817,4681,10498,3408,5109,5732,
5548,YKL042W,5361,5140,10501,3254,5069,3600,
5549,YGR257C,6180,4321,10501,5330,5191,5519,
5550,YLL025W,4722,5779,10501,190,178,215,
5551,YDL169C,5680,4823,10503,5733,5101,2871,
5552,YOL085W-A,4954,5550,10504,5677,6605,6107,
5553,YAL042C-A,5305,5201,10506,6362,6606,6186,
5554,YNL304W,5231,5276,10507,6029,6143,5759,
5555,YDR332W,4678,5830,10508,4531,2755,4695,
5556,YGL174W,6019,4489,10508,5751,5164,4748,
5557,YDR220C,5428,5081,10509,3024,4453,5528,
5558,YOL081W,5040,5469,10509,2896,3165,3922,
5559,YBR033W,4993,5524,10517,4766,4569,5162,
5560,YKR035C,4460,6061,10521,4628,4812,6202,
5561,YDL206W,5205,5316,10521,4165,3393,5054,
5562,YHR071C-A,6075,4446,10521,6414,5972,6655,
5563,YIR015W,4778,5744,10522,6256,6012,4976,
5564,YNL017C,5422,5104,10526,6070,6345,6068,
5565,YNL136W,5810,4718,10528,4135,2761,2458,
5566,YDR209C,5948,4581,10529,1788,5330,5919,
5567,YPL055C,5516,5013,10529,5862,6162,5493,
5568,YHR186C,6157,4378,10535,3308,2261,4094,
5569,YDR329C,5996,4540,10536,6010,5842,5145,
5570,YKL108W,5380,5157,10537,5310,5374,4502,
5571,YDR525W,4879,5658,10537,6385,6385,5947,
5572,YJL161W,6117,4428,10545,6195,5831,5962,
5573,YBL065W,5701,4845,10546,5640,5303,5635,
5574,YDR240C,5768,4780,10548,3564,2599,5036,
5575,YNL150W,5057,5492,10549,5534,4591,5830,
5576,YOR203W,5477,5073,10550,5005,5427,6053,
5577,YPR027C,5403,5148,10551,4292,3058,3780,
5578,YDR355C,6204,4349,10553,6416,5771,6378,
5579,YLR305C,6242,4317,10559,3105,3130,3548,
5580,YPL016W,6272,4289,10561,1710,1457,2661,
5581,YMR053C,5048,5516,10564,4157,3203,4940,
5582,YLR456W,5853,4713,10566,2948,1939,5627,
5583,YLR094C,4588,5978,10566,5726,6086,3785,
5584,YMR191W,6464,4104,10568,4523,4080,5397,
5585,YNL067W-B,5176,5393,10569,4878,2439,5285,
5586,YIL150C,5131,5439,10570,5398,5513,5340,
5587,YLR394W,4404,6168,10572,5547,3824,5653,
5588,YLR417W,5487,5086,10573,5778,5686,5083,
5589,YLR414C,5438,5137,10575,5867,5641,5721,
5590,YCL012C,4866,5712,10578,1815,4495,2461,
5591,YDR004W,4766,5812,10578,5385,4854,5859,
5592,YGR029W,5767,4812,10579,4027,4079,3058,
5593,YCR106W,6373,4207,10580,3703,3174,5291,
5594,YPL006W,6217,4364,10581,3426,2487,3814,
5595,R0030W,5991,4597,10588,6090,6061,6408,
5596,YNL188W,6348,4245,10593,5714,4587,5963,
5597,YDR413C,4287,6306,10593,4728,5309,6326,
5598,YGR221C,4430,6163,10593,5550,4883,5588,
5599,YKR054C,5631,4963,10594,3641,3072,4246,
5600,YMR129W,6404,4192,10596,2008,1794,2697,
5601,YDL079C,4710,5887,10597,3319,4826,3807,
5602,YOR076C,6472,4125,10597,3175,2100,3650,
5603,YIL134C-A,4828,5772,10600,1617,2826,3392,
5604,YNL238W,5221,5381,10602,2599,2778,2543,
5605,YGL113W,5035,5569,10604,4929,4767,4592,
5606,YOL146W,6463,4143,10606,5147,4039,5895,
5607,YNR001W-A,6226,4383,10609,6194,5318,5657,
5608,YIL159W,5678,4931,10609,2810,1713,3601,
5609,YDL211C,4511,6101,10612,5359,5174,5599,
5610,YDR192C,5900,4716,10616,5976,3722,5273,
5611,YMR155W,5804,4813,10617,5460,3608,6088,
5612,YOL037C,6511,4110,10621,6417,6138,6266,
5613,YPL201C,5512,5111,10623,3509,5106,4831,
5614,YOR080W,4265,6360,10625,4393,3021,4753,
5615,YLR434C,5782,4843,10625,1449,435,4278,
5616,YDR269C,5501,5127,10628,5795,5395,6351,
5617,YNL144W-A,5662,4968,10630,2311,4954,6484,
5618,YAL031W-A,6134,4497,10631,4712,5903,6247,
5619,YPR038W,4437,6195,10632,5376,6183,6310,
5620,YDR110W,6282,4351,10633,3739,2243,5013,
5621,YDL187C,4743,5890,10633,5838,5794,6481,
5622,YLR412C-A,5559,5075,10634,5259,5099,3990,
5623,YNL024C-A,6350,4288,10638,4725,3867,5589,
5624,YHR160C,5565,5077,10642,3774,3720,4780,
5625,YPR119W,6148,4495,10643,4300,2564,4497,
5626,YNR044W,4889,5756,10645,3470,1468,4423,
5627,YDR371C-A,6110,4536,10646,727,3147,4116,
5628,YNL012W,4349,6298,10647,4181,2843,3152,
5629,YMR138W,6193,4464,10657,6304,6389,6334,
5630,YCR045C,5706,4952,10658,6108,6421,3451,
5631,YDR159W,5156,5503,10659,2608,1406,3322,
5632,YGR230W,5699,4962,10661,6489,5911,6183,
5633,YDL027C,4446,6218,10664,4527,4356,5358,
5634,YJL022W,6172,4494,10666,5152,3818,6613,
5635,YJL203W,5489,5178,10667,3814,4412,3596,
5636,YLR459W,5497,5171,10668,4142,4207,4906,
5637,YJR039W,5870,4798,10668,3975,3522,4844,
5638,YPR197C,6131,4539,10670,2722,2004,5344,
5639,YPR077C,5175,5496,10671,6368,6278,6083,
5640,YBL054W,5275,5397,10672,3968,4477,2850,
5641,YNR009W,4551,6122,10673,4416,5299,3781,
5642,YLR399W-A,6293,4382,10675,5057,2610,5280,
5643,YLR402W,5080,5596,10676,5172,6182,4660,
5644,YDR386W,4409,6268,10677,4569,3516,4488,
5645,YOR023C,5192,5486,10678,4673,5523,4034,
5646,YDR504C,4106,6574,10680,564,177,2742,
5647,YER132C,4472,6209,10681,4602,3842,4851,
5648,YAL063C,5881,4801,10682,691,996,904,
5649,YMR046W-A,6297,4385,10682,507,286,1703,
5650,YMR150C,4281,6402,10683,5727,3966,5279,
5651,YBL107C,5726,4959,10685,5475,3485,4099,
5652,YPL020C,4628,6057,10685,1540,916,2441,
5653,YOL087C,5299,5386,10685,3557,3239,3517,
5654,YPR159C-A,5681,5006,10687,5469,3561,6464,
5655,YGL109W,4961,5731,10692,5757,5355,5723,
5656,YHR048W,5999,4693,10692,5950,5932,6062,
5657,YKL136W,4620,6073,10693,5750,2628,6227,
5658,YHR006W,5239,5457,10696,5169,4724,4782,
5659,YFR054C,5434,5262,10696,2583,4013,5546,
5660,YMR068W,5292,5406,10698,6291,6227,6179,
5661,YHR004C,4689,6013,10702,4871,4397,5127,
5662,YGR079W,5916,4794,10710,5048,6089,3538,
5663,YPL179W,5924,4787,10711,1757,1158,3209,
5664,YOR073W-A,5633,5078,10711,5519,5704,5821,
5665,YER075C,5406,5306,10712,3397,3628,4188,
5666,YPL159C,4953,5761,10714,4758,4144,4419,
5667,YIL089W,4987,5728,10715,5513,5319,5477,
5668,YAR053W,5313,5403,10716,5899,3293,6320,
5669,YGR107W,4352,6365,10717,6468,6149,6611,
5670,YIL042C,5523,5198,10721,6450,6522,5001,
5671,YDR133C,4902,5822,10724,6608,6284,6650,
5672,YER111C,5306,5419,10725,1715,1052,2756,
5673,YHR028W-A,6034,4692,10726,5106,4572,6102,
5674,YGL052W,6115,4614,10729,2396,4999,6428,
5675,YPR101W,5638,5092,10730,4579,3894,5020,
5676,YFR018C,5531,5203,10734,6656,6653,6419,
5677,YJR089W,4802,5935,10737,2786,2001,3997,
5678,YNL103W-A,4462,6277,10739,1789,5253,6365,
5679,YGL190C,5109,5630,10739,2204,1452,4006,
5680,YBR060C,5050,5689,10739,3180,3708,2501,
5681,YOR244W,4431,6309,10740,2174,2503,4719,
5682,YOL166W-A,4183,6561,10744,1808,3042,5620,
5683,YNL101W,4839,5906,10745,4088,3871,4611,
5684,YLR140W,5076,5670,10746,6328,5967,6355,
5685,YNL097C-B,4882,5864,10746,4617,3296,3894,
5686,YNL171C,5503,5248,10751,2832,2996,6372,
5687,YLR193C,4552,6200,10752,5382,5465,4374,
5688,YBR114W,5427,5326,10753,2785,4072,2849,
5689,YML109W,5871,4883,10754,3084,3487,3388,
5690,YPL056C,5530,5225,10755,6520,6639,6192,
5691,YEL030C-A,5994,4761,10755,5247,5363,6077,
5692,YDR467C,6527,4232,10759,6143,5341,6503,
5693,YPL272C,5318,5444,10762,3239,2484,3430,
5694,YLL012W,5375,5388,10763,3598,4660,2769,
5695,YMR098C,5899,4865,10764,2897,3460,3610,
5696,YDL129W,5592,5173,10765,6217,5734,5522,
5697,YDL088C,4648,6119,10767,2306,1918,3264,
5698,YKL109W,5391,5379,10770,919,1333,1344,
5699,YOR011W-A,4330,6440,10770,1881,3195,6442,
5700,YKR019C,4875,5898,10773,5654,5527,4675,
5701,YMR136W,4411,6363,10774,1542,1989,2483,
5702,YDR316W,6510,4265,10775,2368,1327,2644,
5703,YGR067C,5161,5615,10776,2476,3927,3338,
5704,YKR045C,4856,5923,10779,6560,6434,6423,
5705,YBR051W,4606,6173,10779,5397,5571,6158,
5706,YIL112W,5095,5685,10780,3521,2919,2479,
5707,YAL047C,5442,5339,10781,3612,4539,3048,
5708,YDR460W,6314,4469,10783,4921,5521,3572,
5709,YLR035C-A,5567,5217,10784,2394,3099,4620,
5710,YPR153W,4575,6211,10786,1569,1682,3259,
5711,YEL067C,5119,5667,10786,6323,6208,6507,
5712,YPL062W,5429,5357,10786,6646,6636,6182,
5713,YOR380W,4612,6176,10788,5848,5592,5945,
5714,YOR033C,4634,6158,10792,3435,3632,3581,
5715,YBR289W,5484,5310,10794,5402,3909,4154,
5716,YLL066C,5145,5655,10800,6268,6323,5664,
5717,YNL122C,4698,6103,10801,4505,4070,4960,
5718,YFL015W-A,5641,5162,10803,6650,6542,6511,
5719,YJL007C,5571,5232,10803,3471,3502,5646,
5720,YNL236W,5861,4951,10812,3496,2407,4329,
5721,YCL041C,4639,6174,10813,5949,6319,6413,
5722,YJL005W,5779,5035,10814,4315,3839,4909,
5723,YMR293C,5640,5176,10816,5086,4065,4722,
5724,YHR071W,5591,5226,10817,4486,5019,3738,
5725,YPL046C,5903,4916,10819,6538,6210,6231,
5726,YBL025W,5577,5242,10819,5343,5424,4765,
5727,YPL205C,5118,5702,10820,1154,2672,5303,
5728,YGL179C,5598,5223,10821,5573,4331,5618,
5729,YLR223C,5169,5654,10823,2270,1394,2175,
5730,YJR119C,4841,5983,10824,2442,2389,4151,
5731,YDL159W-A,4261,6569,10830,1594,2783,6491,
5732,YIL071C,4863,5968,10831,3948,2713,5476,
5733,YGR164W,5112,5721,10833,4747,4801,6444,
5734,YAR047C,5051,5782,10833,3745,3306,6354,
5735,YJL149W,4502,6331,10833,1974,4086,3346,
5736,YLR182W,5251,5583,10834,3553,2262,3078,
5737,YCR091W,5394,5441,10835,4322,4452,4068,
5738,YML020W,5470,5368,10838,4595,4607,3450,
5739,YCL069W,5148,5690,10838,3483,4401,5266,
5740,YEL004W,5033,5805,10838,5222,4874,6321,
5741,YER013W,5505,5335,10840,4093,2652,3303,
5742,YDR338C,6310,4531,10841,5080,4664,5641,
5743,YLR286W-A,5651,5190,10841,1840,5851,5434,
5744,YMR313C,5474,5371,10845,4485,3455,4427,
5745,YBL019W,5884,4961,10845,4379,3578,4539,
5746,YOL106W,5995,4851,10846,3992,4656,6150,
5747,YPR123C,6331,4515,10846,5471,6393,5587,
5748,YPL123C,4918,5934,10852,1764,1292,2784,
5749,YPL254W,5551,5301,10852,4465,3374,4408,
5750,YLL046C,5535,5318,10853,4502,2387,2967,
5751,YHL041W,6149,4704,10853,4151,1729,4242,
5752,YHR129C,5890,4970,10860,5878,5090,5677,
5753,YOR049C,5855,5008,10863,2449,3583,3375,
5754,YMR280C,5125,5741,10866,3352,2492,4230,
5755,YKL012W,5414,5454,10868,3757,4092,3210,
5756,YGL226W,6028,4840,10868,6513,6236,6427,
5757,YLL036C,5799,5071,10870,5370,4991,3772,
5758,YPL052W,5150,5720,10870,2222,1276,4358,
5759,YKL003C,4963,5912,10875,5535,5203,4451,
5760,YNL073W,6300,4578,10878,5789,5791,4156,
5761,YDR235W,4804,6078,10882,2351,1707,4391,
5762,YHR185C,5772,5110,10882,2677,1059,4891,
5763,YPL013C,5653,5230,10883,6053,5447,6103,
5764,YOR330C,5061,5823,10884,5477,4993,4153,
5765,YLL010C,5617,5271,10888,5582,5648,5771,
5766,YDL118W,6274,4616,10890,5749,5061,5075,
5767,YDL196W,4979,5926,10905,5644,6176,5923,
5768,YLR425W,5614,5296,10910,3805,2947,4803,
5769,YKL043W,6352,4565,10917,4621,4815,2858,
5770,YJL046W,6414,4506,10920,3887,1817,4623,
5771,YLR329W,4970,5955,10925,5586,4891,6134,
5772,YPL181W,6497,4429,10926,5729,4641,5022,
5773,YDR186C,4848,6079,10927,4568,5509,3590,
5774,YEL028W,4513,6417,10930,5494,5876,5897,
5775,YGR125W,5284,5648,10932,3842,2828,4109,
5776,YIR017W-A,5028,5905,10933,5850,6433,6337,
5777,YDL062W,5745,5189,10934,5621,5114,6504,
5778,YNL043C,5873,5062,10935,5846,2960,5387,
5779,YKR031C,6199,4737,10936,2148,1722,3110,
5780,YDR191W,5236,5701,10937,4992,4410,3332,
5781,YMR299C,5654,5288,10942,3608,3138,4447,
5782,YBL005W,5620,5328,10948,2282,1576,3237,
5783,YDL049C,5390,5563,10953,4408,3757,4579,
5784,YBR076W,4962,5992,10954,3086,3662,4945,
5785,YIL097W,5715,5240,10955,2888,1466,3020,
5786,YMR168C,6354,4601,10955,3191,2998,4351,
5787,YNL221C,5858,5099,10957,4591,4629,4305,
5788,YGR056W,4960,6004,10964,3414,2291,4025,
5789,YHR041C,5637,5334,10971,6635,6669,6100,
5790,YNL228W,5764,5210,10974,2246,3380,5101,
5791,YLR240W,5436,5540,10976,4152,3648,3474,
5792,YDR102C,5935,5055,10990,5089,4075,6187,
5793,YDR136C,5160,5832,10992,6319,5986,6638,
5794,YIL079C,5066,5927,10993,4521,3486,4833,
5795,YGR101W,6571,4423,10994,6250,5609,5917,
5796,YJR136C,6103,4892,10995,5487,5556,5992,
5797,YJL110C,4704,6292,10996,5544,4344,5949,
5798,YKL219W,4862,6135,10997,3719,4246,4013,
5799,YGL139W,5003,5996,10999,2423,1858,3478,
5800,YDL149W,5425,5575,11000,3294,3817,3867,
5801,YJL131C,4895,6105,11000,4813,3559,3611,
5802,YNL152W,6252,4754,11006,4050,3367,4377,
5803,YJR101W,6307,4700,11007,5369,5125,5072,
5804,YHR142W,6029,4983,11012,3513,4900,4521,
5805,YPL080C,5564,5450,11014,5568,5693,6542,
5806,YLR131C,4972,6044,11016,4855,4983,5299,
5807,YPL027W,5459,5557,11016,4086,3236,5002,
5808,YBR158W,5504,5513,11017,3936,2548,5257,
5809,YDR344C,5265,5754,11019,5772,5834,5713,
5810,YOR114W,4597,6423,11020,4279,4017,4587,
5811,YPR009W,6342,4680,11022,4002,4349,5509,
5812,YBL101C,6078,4945,11023,4859,4608,3926,
5813,YNL174W,6059,4964,11023,5206,3711,5317,
5814,YDR259C,5647,5376,11023,2644,2177,4832,
5815,YDR340W,4445,6579,11024,5908,5134,5459,
5816,YDL036C,4983,6045,11028,4478,3256,5188,
5817,YKL149C,6183,4847,11030,2338,2784,4542,
5818,YNR031C,6381,4651,11032,2550,2010,2941,
5819,YLL065W,4379,6655,11034,2251,4185,5817,
5820,YKL183C-A,5331,5708,11039,978,855,2660,
5821,YAL037C-A,5990,5053,11043,3330,5426,3167,
5822,Q0010,4806,6239,11045,3218,1650,5396,
5823,YPL150W,5071,5974,11045,5496,4343,4914,
5824,YER032W,5121,5924,11045,3661,2627,4105,
5825,YDR160W,5500,5553,11053,4653,3620,4667,
5826,YHR154W,4956,6097,11053,3339,1871,3229,
5827,YML087C,5737,5319,11056,5515,4712,4756,
5828,YLR224W,5602,5455,11057,4500,4822,5510,
5829,YKL209C,6248,4809,11057,3705,2692,3463,
5830,YOR248W,4943,6117,11060,6636,6402,6681,
5831,YMR162C,5930,5131,11061,3003,2279,3347,
5832,YDR371W,5264,5797,11061,2562,1322,3177,
5833,YKL118W,5172,5894,11066,3484,3764,5455,
5834,YHL023C,5222,5854,11076,2803,2626,3284,
5835,YMR102C,6382,4696,11078,4547,4205,4147,
5836,YHR078W,5199,5880,11079,4826,4906,5086,
5837,YCR081C-A,4770,6313,11083,5647,6375,6059,
5838,YAL024C,5409,5678,11087,4127,3399,4762,
5839,YMR073C,5716,5372,11088,2973,4675,5316,
5840,YKL168C,5014,6076,11090,4803,4291,5549,
5841,YHL034W-A,4720,6370,11090,6413,4565,6314,
5842,YML053C,5252,5841,11093,1249,3433,4594,
5843,YPL164C,5189,5914,11103,4219,4781,5335,
5844,YAR023C,5573,5534,11107,4427,4438,5282,
5845,YLR181C,5544,5565,11109,5436,3794,3955,
5846,YHR014W,4810,6307,11117,4957,2897,5472,
5847,YDL167C,5944,5175,11119,2261,2149,4371,
5848,YDR200C,6160,4960,11120,3778,2212,3986,
5849,YEL014C,4686,6437,11123,3449,3969,5557,
5850,YML054C-A,4527,6604,11131,4188,5792,5585,
5851,YHR103W,6443,4688,11131,3409,3674,3449,
5852,YOR379C,5472,5660,11132,3424,5952,6578,
5853,YDR488C,6367,4770,11137,6569,6567,6057,
5854,YNL325C,5520,5617,11137,1365,1009,3435,
5855,YDR314C,5385,5753,11138,2661,2042,2885,
5856,YKR051W,5611,5528,11139,3687,2300,5502,
5857,YBR175W,6137,5002,11139,5990,5406,6082,
5858,YDL054C,6357,4783,11140,5975,5652,6094,
5859,YNR066C,6281,4859,11140,2312,2255,3906,
5860,YLR067C,5499,5643,11142,3753,2411,4687,
5861,YFR022W,5607,5536,11143,5617,5221,5394,
5862,YDR464W,6001,5143,11144,4012,3071,2212,
5863,YOL035C,6419,4728,11147,4692,5618,6270,
5864,YDL071C,5283,5867,11150,6296,6283,6375,
5865,YNR020C,4946,6208,11154,5419,5338,5918,
5866,YGL093W,4659,6495,11154,5013,4830,4119,
5867,YJL204C,5975,5181,11156,1973,1884,2227,
5868,YFR056C,5794,5363,11157,5327,5503,6452,
5869,YOL083C-A,5917,5243,11160,3866,5756,6241,
5870,YGL038C,5960,5200,11160,2421,2405,3061,
5871,YPL102C,5204,5956,11160,6153,6477,6512,
5872,YIR021W-A,5812,5352,11164,4991,5751,5270,
5873,YBL071C,5879,5293,11172,4243,5187,6126,
5874,YKL178C,5291,5882,11173,2543,3034,4593,
5875,YJR079W,5034,6141,11175,4199,3248,5742,
5876,YGR147C,6111,5067,11178,6175,6067,5360,
5877,YDR446W,5214,5964,11178,5224,2883,4273,
5878,YDR510C-A,5333,5847,11180,5060,1413,4700,
5879,YHR164C,5456,5725,11181,4667,3933,4275,
5880,YBR005W,6237,4946,11183,6549,6094,5981,
5881,YPR106W,4846,6337,11183,5562,4110,6027,
5882,YER173W,4966,6220,11186,5116,5202,5676,
5883,YMR016C,6065,5125,11190,4580,3454,4536,
5884,YOR072W,4566,6624,11190,6251,6521,6480,
5885,YNL317W,6167,5028,11195,4558,4743,5610,
5886,YLR334C,5519,5677,11196,2135,3363,5497,
5887,YLR266C,5255,5941,11196,3495,2976,4395,
5888,YNL265C,6171,5034,11205,3883,4131,2273,
5889,YPR203W,5117,6092,11209,6016,6036,5643,
5890,YLR162W-A,5537,5672,11209,5101,5119,4643,
5891,YOR137C,6287,4925,11212,3253,2420,4316,
5892,YGR239C,5347,5866,11213,5811,6119,4455,
5893,YLL059C,6286,4928,11214,6438,6072,6230,
5894,YBL039W-B,5758,5459,11217,3271,2125,5153,
5895,YOR178C,5330,5889,11219,2228,2298,4044,
5896,YDR320C-A,6560,4661,11221,6273,6426,6496,
5897,YBR165W,4844,6379,11223,3143,3789,4902,
5898,YPR095C,4854,6369,11223,4777,4037,4835,
5899,YDR125C,5273,5951,11224,2567,2155,3854,
5900,YGR182C,5007,6217,11224,5673,4598,6448,
5901,YOL068C,5105,6123,11228,4207,3734,5025,
5902,YHR180C-B,5724,5505,11229,5847,5413,4445,
5903,YMR190C,5138,6091,11229,3338,3013,3613,
5904,YGR133W,6018,5212,11230,5629,6181,5926,
5905,YOL036W,4951,6280,11231,5660,5302,5564,
5906,YEL050C,6256,4975,11231,2727,3995,2895,
5907,YFR035C,4831,6401,11232,6365,6312,6443,
5908,YNL298W,6116,5117,11233,3590,2729,4161,
5909,YGR249W,6039,5199,11238,4732,4227,5623,
5910,YAL064W-B,5759,5479,11238,6509,5596,5672,
5911,YNL038W,5366,5873,11239,5432,5272,6220,
5912,YGL072C,6378,4862,11240,6528,6640,6597,
5913,YOR107W,5659,5581,11240,5762,6054,5464,
5914,YGR122W,6212,5030,11242,5711,5292,4997,
5915,YER040W,5509,5733,11242,5031,4845,5535,
5916,YER038C,5818,5426,11244,2213,2216,2786,
5917,YFL015C,5012,6232,11244,6209,6439,6212,
5918,YGL192W,6311,4935,11246,4506,4192,3981,
5919,YAL009W,6182,5064,11246,5667,5634,5407,
5920,YBL104C,5763,5484,11247,2346,2427,4010,
5921,YEL018W,5998,5251,11249,5410,5749,5064,
5922,YKL145W-A,6266,4985,11251,6675,6562,6657,
5923,YGL096W,5240,6012,11252,5502,4947,5748,
5924,YML049C,5842,5412,11254,3245,3710,3838,
5925,YDR478W,6539,4717,11256,5754,5139,6093,
5926,YEL025C,5790,5467,11257,3874,3443,5156,
5927,YPR161C,5785,5473,11258,5100,3245,4663,
5928,YFR034W-A,6534,4725,11259,6234,6024,5155,
5929,YGR290W,6440,4820,11260,2851,2274,5181,
5930,YNL008C,5668,5592,11260,3075,2237,4788,
5931,YGL217C,5702,5564,11266,6213,6161,6075,
5932,YMR017W,5624,5644,11268,4746,5466,4924,
5933,YGL237C,6451,4818,11269,5926,4995,6006,
5934,YIL152W,4994,6276,11270,6374,6285,6335,
5935,YNL029C,5710,5561,11271,5628,5947,4527,
5936,YLR098C,6243,5031,11274,3291,2638,3099,
5937,YIL037C,5502,5773,11275,4951,3551,5466,
5938,YPR136C,5357,5919,11276,5287,3151,5872,
5939,YER188C-A,4695,6584,11279,2209,2229,5341,
5940,YPL172C,6044,5237,11281,4058,3388,5746,
5941,YOR060C,5849,5434,11283,6222,5956,6215,
5942,YJL083W,4913,6371,11284,6159,6075,5959,
5943,YIL032C,4727,6557,11284,6478,6226,6516,
5944,YBR230W-A,5822,5468,11290,6505,6578,4912,
5945,YLR299W,5364,5928,11292,4987,4935,4211,
5946,YHR166C,6041,5261,11302,4645,4864,5697,
5947,YPR068C,6365,4938,11303,4062,3861,5979,
5948,YPR109W,5957,5358,11315,5284,4979,6079,
5949,YER059W,5358,5960,11318,5278,4025,4992,
5950,YOR054C,5365,5953,11318,4007,4897,3335,
5951,YGL003C,5962,5359,11321,5320,4497,5912,
5952,YKR087C,6558,4764,11322,4680,3218,5304,
5953,YNL083W,5608,5716,11324,4497,5190,4552,
5954,YFR010W-A,5055,6270,11325,2636,4908,6282,
5955,YPL044C,5742,5587,11329,5997,5454,6110,
5956,YLR446W,5495,5836,11331,4897,4674,5297,
5957,YER035W,5424,5909,11333,6499,6333,5120,
5958,YPL114W,5746,5588,11334,6420,5763,6479,
5959,YER051W,6096,5238,11334,3241,2616,3403,
5960,YAL068W-A,4939,6400,11339,1186,1083,5927,
5961,YJL205C,5001,6339,11340,6230,6269,6112,
5962,YOR316C-A,4871,6470,11341,6465,6596,6494,
5963,YLR242C,5965,5378,11343,3898,4444,5668,
5964,YNL213C,5630,5715,11345,4835,4862,4272,
5965,YMR101C,5642,5705,11347,2612,745,3366,
5966,YDR103W,6343,5010,11353,2901,2072,4591,
5967,YGL214W,5395,5958,11353,4597,1143,5799,
5968,YDR260C,5440,5913,11353,6098,5769,5508,
5969,YMR137C,5278,6077,11355,3363,2794,4990,
5970,YNL233W,6247,5112,11359,3485,3284,4785,
5971,YGR089W,6026,5333,11359,1701,1381,2757,
5972,YFL032W,5616,5745,11361,5040,5717,6206,
5973,YDL194W,6351,5014,11365,3871,3225,4742,
5974,YPL026C,5997,5369,11366,2801,3580,3476,
5975,YCR085W,5798,5573,11371,4866,2246,5781,
5976,YDR320W-B,5845,5526,11371,4433,4334,5757,
5977,YDR179W-A,5946,5425,11371,2922,1633,5263,
5978,YBR097W,6211,5161,11372,2522,1659,3583,
5979,YMR275C,6306,5066,11372,4371,4484,3882,
5980,YGL006W-A,4865,6508,11373,5150,5301,4361,
5981,YPL057C,6506,4876,11382,1968,3167,3135,
5982,YER152W-A,6359,5023,11382,6614,6656,6646,
5983,YJR162C,4769,6618,11387,2444,4848,5468,
5984,YER140W,5287,6106,11393,5507,5430,5768,
5985,YGL165C,5165,6234,11399,6361,5884,6380,
5986,YAL020C,5072,6328,11400,6662,6629,6155,
5987,YPR186C,5896,5504,11400,4636,3431,5782,
5988,YPR013C,6360,5040,11400,3976,2658,5242,
5989,YGR174W-A,4723,6683,11406,6284,383,5449,
5990,YNL187W,5549,5857,11406,6301,6424,6098,
5991,YPR204W,6030,5377,11407,6023,6180,4860,
5992,YBR300C,5215,6196,11411,6011,5772,6520,
5993,YFL065C,5349,6063,11412,6060,6147,5567,
5994,YDL114W-A,5588,5829,11417,952,716,4904,
5995,YCR108C,5728,5693,11421,4854,5944,5946,
5996,YIR040C,5534,5888,11422,5770,5752,6398,
5997,YLR191W,5661,5764,11425,6132,5394,5474,
5998,YLR091W,5867,5559,11426,6464,6418,6313,
5999,YHR021W-A,5022,6406,11428,2856,3440,6163,
6000,YCR087W,5159,6274,11433,6624,6628,6684,
6001,YGL249W,5562,5885,11447,2247,1775,3049,
6002,YDL048C,5393,6054,11447,4641,5539,3813,
6003,YKR044W,5932,5518,11450,6087,5918,4436,
6004,YOR050C,6371,5084,11455,6572,6630,6637,
6005,YNL082W,6368,5088,11456,3087,1669,4287,
6006,YKL022C,5247,6210,11457,4380,3087,3777,
6007,YDR114C,5062,6396,11458,4689,5963,6389,
6008,YNL293W,5749,5711,11460,5333,5234,4683,
6009,YKR098C,5696,5765,11461,3867,3192,4449,
6010,YCR075C,5096,6368,11464,6183,5979,6217,
6011,YLR111W,5569,5895,11464,6576,6507,6061,
6012,YMR306C-A,5481,5986,11467,6541,6120,6534,
6013,YPL180W,5674,5794,11468,4341,3180,4698,
6014,YNL289W,5402,6066,11468,5565,6102,4474,
6015,YJL006C,6262,5207,11469,4862,3134,5042,
6016,YMR035W,6066,5405,11471,6199,5845,6255,
6017,YDR475C,5865,5606,11471,5756,5672,5375,
6018,YBR277C,6362,5113,11475,5669,5104,5976,
6019,YOL166C,4905,6571,11476,6013,5500,6409,
6020,YHR050W-A,4899,6582,11481,4023,1469,4723,
6021,YGL182C,6469,5016,11485,5799,5984,6249,
6022,YDL114W,4975,6511,11486,5248,4217,5913,
6023,YFR052C-A,5600,5886,11486,6357,5339,6627,
6024,YPL147W,5248,6241,11489,3158,2289,2907,
6025,YNL159C,5626,5865,11491,5378,4661,5429,
6026,YDL240W,6084,5408,11492,3189,2305,3492,
6027,YNL116W,5843,5650,11493,4503,4655,4125,
6028,YIR033W,5938,5562,11500,2212,2158,3182,
6029,YJL023C,6349,5151,11500,3419,2934,5823,
6030,YGR050C,5246,6258,11504,6514,6144,6500,
6031,YPL119C-A,5170,6336,11506,2951,2194,6323,
6032,YLR099C,5243,6266,11509,5994,6352,4123,
6033,YDL028C,5081,6430,11511,4601,2879,5805,
6034,YIL030W-A,6397,5118,11515,5228,5283,6370,
6035,YLR392C,5973,5546,11519,4276,3699,4645,
6036,YOR147W,6113,5407,11520,3060,3142,4145,
6037,YNL283C,5515,6005,11520,4837,5065,4390,
6038,YDR048C,5261,6260,11521,4993,2152,6515,
6039,YNR067C,5379,6143,11522,1711,852,2827,
6040,YPL270W,6608,4915,11523,5503,4610,4528,
6041,YIL023C,5580,5946,11526,6483,6456,6157,
6042,YIL001W,5211,6316,11527,4598,4254,5814,
6043,YJR038C,5866,5665,11531,6281,6416,6545,
6044,YHR056W-A,5259,6285,11544,6286,6506,6529,
6045,YOR024W,6107,5438,11545,6575,6362,6635,
6046,YIL113W,6095,5453,11548,6442,6355,6434,
6047,YLR313C,5143,6409,11552,5537,4905,5797,
6048,YDR027C,5827,5727,11554,4917,4230,4603,
6049,YLR289W,6024,5533,11557,5596,4107,5154,
6050,YGL088W,5220,6338,11558,6085,5701,6257,
6051,YNL054W,6020,5544,11564,3601,3724,4554,
6052,YPR014C,5784,5781,11565,6481,6136,5822,
6053,YOL160W,5770,5796,11566,3137,4255,5786,
6054,YJL078C,5201,6367,11568,4241,5488,4159,
6055,YHL029C,5966,5604,11570,2716,4436,3778,
6056,YDR464C-A,5663,5908,11571,6500,6108,6388,
6057,YDL138W,5376,6198,11574,5026,5476,4932,
6058,YHR157W,5266,6310,11576,6204,5638,6403,
6059,YHR145C,5293,6288,11581,4508,4182,5971,
6060,YJL016W,5705,5881,11586,2687,3161,3748,
6061,YDR219C,5079,6515,11594,4283,2184,4567,
6062,YGR293C,5408,6186,11594,6243,5733,6550,
6063,YNL322C,6046,5551,11597,5025,5289,2395,
6064,YDR085C,6081,5517,11598,3715,3064,4171,
6065,YBR163W,5910,5691,11601,3169,2172,4249,
6066,YDR319C,6223,5382,11605,2789,2684,5701,
6067,YOL011W,6278,5332,11610,1825,1935,2032,
6068,YPR012W,6502,5109,11611,3682,5598,5968,
6069,YJL047C,6053,5558,11611,4464,4571,4759,
6070,YDL080C,6361,5252,11613,5344,4681,5616,
6071,YPL141C,5743,5872,11615,4205,3772,4459,
6072,YBR270C,5774,5843,11617,5885,5662,5766,
6073,YGL188C,5677,5944,11621,656,673,5728,
6074,YBL052C,5370,6252,11622,2996,2268,3848,
6075,YHR124W,5363,6259,11622,4836,2573,4776,
6076,YDL069C,5635,5989,11624,4763,4625,6133,
6077,YOR008W-B,6417,5208,11625,6671,6580,5239,
6078,YNL146W,6228,5401,11629,2528,4442,6251,
6079,YDL070W,5582,6052,11634,1809,1835,2239,
6080,YNL013C,5282,6354,11636,2202,5980,6333,
6081,YDL233W,6478,5166,11644,4984,4378,3821,
6082,YGR291C,5950,5695,11645,6269,6035,5496,
6083,YFR027W,5465,6181,11646,6401,5784,5709,
6084,YOR282W,5656,5991,11647,6075,5882,6626,
6085,YJL129C,5898,5750,11648,3155,3507,4448,
6086,YMR069W,5521,6129,11650,6566,6649,6348,
6087,YBL081W,6612,5038,11650,2932,5715,2664,
6088,YML111W,5915,5738,11653,2635,2008,3703,
6089,YMR100W,5334,6322,11656,3344,2663,4955,
6090,YGL021W,5506,6150,11656,3050,2315,3640,
6091,YML007C-A,6664,4995,11659,5408,6376,6667,
6092,YMR005W,6557,5102,11659,5069,3613,3373,
6093,YBL100W-C,6587,5072,11659,4760,5185,5776,
6094,YKL066W,6222,5437,11659,5988,5683,6493,
6095,YHR054W-A,6230,5430,11660,3605,6113,3224,
6096,YFR048W,6133,5532,11665,4403,3563,3351,
6097,YDR315C,6379,5286,11665,2719,2334,5430,
6098,YGR099W,6462,5205,11667,5947,5643,5864,
6099,YNL285W,5513,6155,11668,5096,6123,6347,
6100,YKL185W,5235,6439,11674,5035,4493,5632,
6101,YPL018W,5825,5850,11675,5841,5819,4712,
6102,YKL096C-B,5188,6488,11676,1503,171,1630,
6103,YDL199C,6014,5664,11678,5480,5320,5884,
6104,YCR022C,5354,6325,11679,6485,6473,6672,
6105,YHR199C-A,6200,5480,11680,6673,6622,6524,
6106,YJR050W,5517,6165,11682,5486,4058,5487,
6107,YOL044W,6089,5594,11683,5306,4823,5708,
6108,YKL101W,6067,5616,11683,4312,2730,3545,
6109,YMR287C,5636,6050,11686,4781,3202,5214,
6110,YKR064W,6471,5222,11693,2367,2162,5150,
6111,YNL120C,5967,5729,11696,4895,4001,6087,
6112,YJR157W,6213,5487,11700,2078,1711,5844,
6113,YOR146W,5808,5897,11705,6381,5836,6425,
6114,YML090W,6277,5433,11710,3469,924,6277,
6115,YDR112W,5526,6185,11711,4410,3461,5689,
6116,YER158C,5649,6070,11719,4618,5153,3432,
6117,YHL050C,5964,5755,11719,6283,6273,5207,
6118,YPL162C,5972,5751,11723,5219,5296,5033,
6119,YER088C-A,5947,5777,11724,6475,6537,5506,
6120,YDR295C,5788,5942,11730,4214,3684,4072,
6121,YLR252W,5830,5901,11731,3727,3991,6091,
6122,YLR443W,6106,5631,11737,5630,5141,5573,
6123,YLR255C,6174,5566,11740,6638,6603,6078,
6124,YHR159W,6568,5174,11742,6056,5797,6290,
6125,YOR008C-A,5733,6009,11742,4518,3263,6258,
6126,YGL073W,6125,5618,11743,3910,4461,4308,
6127,YPR042C,5709,6035,11744,4227,2870,5008,
6128,YNL047C,5387,6358,11745,5033,4725,4098,
6129,YPL029W,5887,5860,11747,5111,4480,4366,
6130,YKR010C,5601,6147,11748,3712,2532,4048,
6131,YMR173W-A,5392,6356,11748,4776,1021,5355,
6132,YDR326C,5658,6095,11753,2037,1400,3062,
6133,YLR040C,5522,6233,11755,1998,2916,2980,
6134,YGR150C,6261,5497,11758,2243,1700,3143,
6135,YOR349W,6013,5747,11760,4200,5120,4596,
6136,YNL295W,5619,6142,11761,5623,4996,5240,
6137,YPL157W,6054,5707,11761,5665,5167,5671,
6138,YGL193C,5463,6301,11764,5633,5770,6601,
6139,YDL175C,5475,6290,11765,3989,3285,5800,
6140,YEL016C,6009,5757,11766,4754,5304,5416,
6141,YOL085C,6033,5739,11772,6264,6449,6497,
6142,YAR031W,6072,5704,11776,5238,5332,5679,
6143,YER033C,5986,5792,11778,3100,3397,4314,
6144,YPL038W-A,5343,6438,11781,1262,362,2420,
6145,YHR082C,6370,5415,11785,1172,918,1956,
6146,YHR052W-A,6321,5465,11786,3603,6112,3223,
6147,YDL176W,5237,6549,11786,4064,3216,5924,
6148,YNL198C,5704,6085,11789,5540,6126,6237,
6149,YNR077C,5209,6583,11792,1920,1857,5659,
6150,YOR335W-A,5139,6657,11796,3176,645,6668,
6151,YLR148W,6509,5295,11804,1866,2397,2778,
6152,YIL100W,6482,5322,11804,6480,6254,5124,
6153,YGR222W,5856,5948,11804,5736,5248,5794,
6154,YOR058C,5791,6016,11807,3790,2063,3265,
6155,YOR188W,5905,5904,11809,3973,2972,4574,
6156,YMR001C-A,5493,6317,11810,1120,188,2959,
6157,YPL182C,6312,5502,11814,5881,5627,6071,
6158,YHR059W,6433,5383,11816,2800,4369,3621,
6159,YBR219C,5179,6637,11816,6017,6245,6076,
6160,YJR128W,6232,5589,11821,6640,6617,6653,
6161,YKR091W,5945,5878,11823,6289,5659,5533,
6162,YKL188C,5712,6120,11832,4626,2614,3875,
6163,YPR150W,6191,5645,11836,5591,6235,5115,
6164,YLR422W,6412,5429,11841,4263,3451,4828,
6165,YGR031C-A,5683,6159,11842,6551,6516,6042,
6166,YOR062C,5386,6458,11844,4791,5703,5068,
6167,YOR211C,5838,6006,11844,2875,1849,2066,
6168,YLR145W,5669,6184,11853,6077,5189,5376,
6169,YDR405W,5553,6302,11855,6516,6569,5825,
6170,YDR331W,6267,5597,11864,2961,3554,4022,
6171,YJL156W-A,5480,6385,11865,6360,4315,6536,
6172,YML027W,6276,5590,11866,5355,5955,4639,
6173,YHR150W,5372,6496,11868,5648,4784,5141,
6174,YER155C,6513,5355,11868,1879,1476,3208,
6175,YHR032W-A,5413,6457,11870,6586,6593,6634,
6176,YOR072W-B,5238,6634,11872,5821,5367,4277,
6177,YJR140W-A,5286,6586,11872,6082,5060,6117,
6178,YPL144W,5877,5997,11874,6387,5939,6165,
6179,YCR006C,6177,5698,11875,6601,6648,6473,
6180,YIL049W,5461,6422,11883,4163,4159,6214,
6181,YJR106W,5543,6345,11888,5373,5105,5437,
6182,YAR070C,5708,6182,11890,4682,5933,6285,
6183,YBR134W,5323,6568,11891,5108,4727,5678,
6184,YNL327W,5471,6420,11891,2184,1818,3864,
6185,YMR317W,6657,5236,11893,5286,3760,5350,
6186,YFL052W,6346,5547,11893,5905,5907,6410,
6187,YNL139C,6593,5308,11901,2150,1681,2563,
6188,YOR373W,6161,5740,11901,5166,5510,4103,
6189,YOL001W,5672,6231,11903,5703,5103,6449,
6190,YOR255W,5714,6191,11905,4710,4917,4728,
6191,YJL105W,5432,6475,11907,5180,2722,5169,
6192,YPR145C-A,5498,6410,11908,6488,5516,6544,
6193,YOR113W,6334,5574,11908,3735,3464,5000,
6194,YOR072W-A,5949,5963,11912,6643,6652,6658,
6195,YMR326C,5697,6216,11913,1465,2383,5987,
6196,YHL005C,5315,6602,11917,6523,6349,6555,
6197,YGR036C,5803,6116,11919,4902,4873,5325,
6198,YNL089C,5807,6113,11920,4887,2939,5597,
6199,YIR025W,5538,6383,11921,5959,5208,5739,
6200,YJL052C-A,5533,6392,11925,2941,6001,6322,
6201,YML094C-A,6003,5925,11928,5236,3690,6506,
6202,YJL107C,6618,5314,11932,3906,3415,2989,
6203,YLR041W,6158,5778,11936,6318,4638,5889,
6204,YOR169C,6515,5423,11938,612,1487,5073,
6205,YGR031W,6035,5903,11938,6443,6498,6038,
6206,YLL015W,6353,5585,11938,2781,1708,2860,
6207,YBR138C,6108,5831,11939,3097,2786,4213,
6208,YKL011C,6147,5793,11940,4704,3187,4915,
6209,YAR050W,6048,5893,11941,611,974,759,
6210,YOR301W,6390,5552,11942,6329,6501,5993,
6211,YNL338W,6520,5424,11944,2628,6425,6194,
6212,YOR353C,5775,6169,11944,5569,3876,5170,
6213,YJL099W,6547,5399,11946,4325,4911,5513,
6214,YLR466W,5615,6332,11947,6255,6298,5873,
6215,YHR194W,6101,5848,11949,5877,6300,4807,
6216,YKL169C,6002,5947,11949,4945,5473,6097,
6217,YMR265C,6302,5652,11954,6084,6047,5426,
6218,YCL002C,6674,5289,11963,5276,3558,6160,
6219,YJL133W,5939,6025,11964,6123,5314,6121,
6220,YNL146C-A,6032,5932,11964,2601,1251,4984,
6221,YDR241W,6556,5417,11973,4600,2518,6402,
6222,YKL223W,6068,5907,11975,5875,5872,6451,
6223,YLR310C,6255,5722,11977,3369,2292,3733,
6224,YER113C,6221,5759,11980,4202,4263,5530,
6225,YJL015C,6481,5499,11980,1708,3345,6084,
6226,YMR052C-A,5954,6026,11980,4736,4931,5893,
6227,YLR122C,6063,5920,11983,5851,5869,5783,
6228,YOR364W,6263,5724,11987,5713,6187,6308,
6229,YMR315W-A,5888,6100,11988,6408,6632,6132,
6230,YMR057C,5670,6319,11989,6655,6616,6538,
6231,YER137W-A,6376,5614,11990,2847,3677,6184,
6232,YMR206W,5464,6527,11991,5911,5844,4892,
6233,YDR223W,5460,6539,11999,5549,5380,5966,
6234,YLR311C,5568,6433,12001,5745,4590,6618,
6235,YMR141C,6205,5800,12005,5557,4668,6286,
6236,YFL003C,5754,6254,12008,4720,3671,5767,
6237,YKR075C,6295,5714,12009,2468,5362,2486,
6238,YGL152C,5760,6251,12011,6000,5278,5669,
6239,YHL019C,6049,5965,12014,5381,5800,4134,
6240,YJR030C,5735,6283,12018,4828,4698,5726,
6241,YOR156C,5719,6300,12019,4936,4078,5092,
6242,YHR130C,5700,6323,12023,2125,1450,6131,
6243,YCL005W,5604,6419,12023,6021,6074,6338,
6244,YBR064W,5878,6146,12024,5946,4953,5929,
6245,YEL008C-A,5885,6140,12025,6233,5827,6385,
6246,YKL034W,5904,6131,12035,4040,4362,5417,
6247,YDR130C,5941,6094,12035,6104,5970,6141,
6248,YNL170W,5751,6287,12038,4605,1715,5569,
6249,YER097W,5952,6086,12038,6122,6255,6167,
6250,YGR045C,6139,5900,12039,6246,5814,6364,
6251,YPR142C,5485,6554,12039,6051,5025,6397,
6252,YNL303W,5574,6467,12041,1784,347,5967,
6253,YDR208W,6542,5508,12050,3057,3179,4531,
6254,YIL102C-A,6085,5966,12051,5707,6070,5916,
6255,YBR161W,6239,5816,12055,3213,3498,2732,
6256,YKR103W,6219,5842,12061,3526,2804,4220,
6257,YDR072C,6320,5742,12062,2713,4677,3559,
6258,YLL006W-A,5875,6187,12062,963,4915,2728,
6259,YJL180C,6582,5481,12063,5232,4047,3723,
6260,YPL109C,6069,5995,12064,3072,3364,4456,
6261,YKL097C,5508,6556,12064,6669,6568,6461,
6262,YIL156W,6056,6008,12064,4876,5080,4510,
6263,YOL138C,5953,6112,12065,4209,4448,4265,
6264,YJL209W,5673,6393,12066,2152,3421,3693,
6265,YOR170W,6143,5930,12073,1086,877,4102,
6266,YOR304W,6198,5875,12073,1616,1187,1721,
6267,YIL142C-A,6023,6055,12078,6129,6122,6541,
6268,YML009C-A,5586,6494,12080,5509,6454,6580,
6269,YKL222C,6476,5605,12081,3421,2885,5184,
6270,YPR064W,6567,5515,12082,6625,6496,6602,
6271,YCL022C,5729,6353,12082,6285,5716,6127,
6272,YPL005W,5548,6535,12083,5641,4890,5351,
6273,YHR213W-B,6401,5683,12084,6457,6532,6331,
6274,YLR154W-E,5831,6256,12087,5656,4218,5235,
6275,YOR376W-A,5912,6177,12089,1876,703,5405,
6276,YBL107W-A,5628,6461,12089,1421,416,5978,
6277,YIR020C,5491,6599,12090,5721,4760,5577,
6278,YLR238W,6269,5825,12094,5038,3875,4635,
6279,YPL097W,6606,5489,12095,5659,4994,5922,
6280,YDR543C,5627,6473,12100,2688,3096,5423,
6281,YLL020C,5753,6350,12103,4551,3111,6336,
6282,YNR042W,6508,5599,12107,6610,6592,6526,
6283,YFL012W,5722,6387,12109,5191,3910,6051,
6284,YKL048C,5776,6340,12116,5523,4416,5903,
6285,YMR209C,6031,6087,12118,5427,5122,5650,
6286,YOL105C,5691,6431,12122,4351,3325,4981,
6287,YER077C,5977,6153,12130,4909,4714,4668,
6288,YPL202C,6150,5982,12132,3664,2325,3231,
6289,YDR254W,5929,6207,12136,4818,3233,5365,
6290,YKR086W,6290,5846,12136,4327,3247,3939,
6291,YMR175W-A,6188,5950,12138,1391,360,6203,
6292,YLR318W,6218,5922,12140,1895,1552,3880,
6293,YPL135C-A,5809,6334,12143,6592,6088,5540,
6294,YER153C,6592,5555,12147,6681,6672,6560,
6295,YAL019W-A,5959,6189,12148,6208,6587,6003,
6296,YOL038C-A,5694,6456,12150,6197,4782,4162,
6297,YPL092W,6454,5697,12151,4694,4206,4047,
6298,YBL089W,6407,5746,12153,5800,5263,5621,
6299,YJL225W-A,5980,6175,12155,6310,6519,6565,
6300,YEL077W-A,5833,6326,12159,6340,6528,6576,
6301,YPL261C,5660,6499,12159,5999,5113,6619,
6302,YLR436C,6050,6110,12160,3322,4350,4994,
6303,YLR454W,6430,5730,12160,1739,1253,2371,
6304,YMR316C-A,5819,6347,12166,5366,4597,5848,
6305,YEL059W,6042,6126,12168,6298,6386,6552,
6306,YLR349W,5958,6212,12170,6510,6452,6340,
6307,YBR200W-A,6080,6090,12170,5052,5858,6232,
6308,YDL035C,5992,6178,12170,3380,3404,5004,
6309,YIL177W-A,6005,6166,12171,6309,6518,6567,
6310,YOR199W,6209,5962,12171,5730,5502,6579,
6311,YLR366W,5789,6384,12173,4896,5870,6407,
6312,YDR545C-A,6004,6171,12175,6415,6582,6596,
6313,YLR281C,6363,5818,12181,6680,6683,6543,
6314,YER093C,5889,6295,12184,4935,4863,4763,
6315,YKL105C,6514,5676,12190,5263,4763,4482,
6316,YMR320W,5942,6248,12190,5155,4793,5898,
6317,YFL066C,6091,6099,12190,6406,6290,4821,
6318,YLL033W,5690,6504,12194,5270,4751,5988,
6319,YOL078W,5805,6389,12194,4288,3986,4582,
6320,YJL127W-A,6425,5769,12194,6568,6021,6557,
6321,YLL005C,5970,6225,12195,3432,2706,5060,
6322,YOR200W,6333,5863,12196,5888,5183,6233,
6323,YGL149W,6185,6027,12212,6202,6288,6628,
6324,YLR264C-A,5837,6382,12219,3267,697,2328,
6325,YPR016W-A,6422,5798,12220,3832,1107,4184,
6326,YGR011W,6124,6098,12222,5827,5370,6173,
6327,YOR034C-A,5850,6374,12224,4066,3524,4560,
6328,YDR274C,5802,6424,12226,6591,6612,6401,
6329,YGL176C,6487,5743,12230,3755,3607,4995,
6330,YNR060W,6079,6151,12230,2979,2696,2708,
6331,YCR041W,6601,5633,12234,3944,4156,6412,
6332,YPL008W,5993,6244,12237,5049,3790,4837,
6333,YNL230C,6531,5706,12237,5168,5710,3950,
6334,YFL012W-A,6634,5613,12247,6181,5368,6519,
6335,YDR078C,5814,6434,12248,4001,1952,4977,
6336,YKR012C,6195,6068,12263,5912,5107,6589,
6337,YOR032W-A,6196,6067,12263,4884,5334,6106,
6338,YIR014W,6051,6213,12264,6557,6455,6447,
6339,YMR272W-A,6543,5723,12266,3445,6602,5353,
6340,YNL337W,5740,6528,12268,1860,1851,5354,
6341,YKL171W,6144,6125,12269,4919,4744,5451,
6342,YPL255W,6431,5840,12271,5761,5671,5306,
6343,YPL003W,6555,5719,12274,5982,5162,5693,
6344,YLR084C,6165,6114,12279,3830,3352,5037,
6345,YLR001C,6493,5788,12281,4210,4302,5259,
6346,YDR249C,6173,6115,12288,4807,3510,5034,
6347,YFL031C-A,5824,6465,12289,6501,6006,6471,
6348,YJL094C,6280,6011,12291,3852,3132,3357,
6349,YNL063W,5951,6341,12292,6035,5886,6210,
6350,YPL221W,6485,5814,12299,3640,4948,3504,
6351,YPR146C,5979,6321,12300,6476,5636,6631,
6352,YCR033W,6025,6281,12306,4850,3553,4590,
6353,YGR064W,5731,6576,12307,5815,6048,6510,
6354,YMR274C,6507,5802,12309,5601,4875,6174,
6355,YGL262W,6332,5981,12313,4967,3728,5113,
6356,YJL182C,6043,6282,12325,6093,6318,6383,
6357,YJL222W-A,5874,6451,12325,6383,6407,6465,
6358,YIL141W,6238,6088,12326,5251,5714,6439,
6359,YCR001W,6062,6265,12327,2445,823,6327,
6360,YOL013W-B,6074,6255,12329,2380,1293,6114,
6361,YKL044W,5739,6596,12335,5626,5633,6312,
6362,YJL095W,6550,5785,12335,4516,2805,4222,
6363,YML100W-A,5984,6351,12335,6615,6334,5812,
6364,YJL103C,5931,6405,12336,4360,3727,4846,
6365,YGR015C,5974,6364,12338,5474,4692,5758,
6366,YDR366C,5769,6575,12344,3588,2423,4336,
6367,YFR036W-A,6146,6199,12345,5492,6196,5854,
6368,YKR073C,5971,6376,12347,6080,6188,6537,
6369,YFR032C-B,5757,6591,12348,5511,5605,6116,
6370,YMR204C,5846,6507,12353,5225,3688,5753,
6371,YOR005C,5933,6421,12354,5068,4776,5791,
6372,YER046W-A,6040,6314,12354,4024,2654,6030,
6373,YOR315W,6253,6104,12357,5277,4990,5824,
6374,YCL065W,6562,5795,12357,3822,3570,6377,
6375,YDR349C,6210,6148,12358,4988,4290,5326,
6376,YGR265W,6082,6279,12361,5395,4403,5622,
6377,YML047C,6304,6059,12363,3862,3913,4777,
6378,YHR022C-A,6340,6023,12363,6229,6409,6669,
6379,YJR023C,6138,6228,12366,5543,2410,6035,
6380,YIL029C,6337,6036,12373,4065,4102,5649,
6381,YEL033W,5811,6567,12378,6456,5588,6177,
6382,YGR296C-B,6061,6318,12379,6345,6553,6564,
6383,YDR076W,6355,6030,12385,5014,5313,5562,
6384,YJR087W,6027,6359,12386,5321,4926,6299,
6385,YMR304C-A,6231,6156,12387,5483,3264,6424,
6386,YGR139W,6017,6375,12392,4340,1055,6019,
6387,YHL050W-A,5923,6472,12395,6429,6561,6600,
6388,YIL045W,6420,5975,12395,2219,2977,3148,
6389,YPR204C-A,6114,6284,12398,6349,6552,6566,
6390,YGR188C,6100,6299,12399,4616,3957,4778,
6391,YLR163W-A,6613,5789,12402,6041,4564,6188,
6392,YJL118W,6208,6197,12405,6375,6557,6436,
6393,YER087C-A,6000,6407,12407,5855,4562,6469,
6394,YER190C-B,6170,6238,12408,6348,6554,6561,
6395,YIL020C-A,6162,6247,12409,1381,4588,6017,
6396,YHR180W-A,6448,5969,12417,5953,5173,6495,
6397,YDL216C,6227,6192,12419,4501,4647,5751,
6398,YPR039W,5860,6559,12419,4596,4170,6222,
6399,YDR246W-A,6436,5988,12424,6550,6647,6525,
6400,YIL174W,6011,6416,12427,6382,6405,6466,
6401,YBR063C,6010,6418,12428,3679,3207,5404,
6402,YKL030W,6427,6002,12429,6109,5589,6356,
6403,YML064C,6408,6022,12430,6467,6096,5954,
6404,YLR426W,6646,5784,12430,6394,6367,6259,
6405,YIL101C,6325,6107,12432,5413,6037,4251,
6406,YOR186C-A,6076,6361,12437,6275,5991,5787,
6407,YDR524C-A,6391,6049,12440,4635,6276,5582,
6408,YGL042C,6152,6291,12443,1684,4059,6152,
6409,YLR024C,6554,5892,12446,2929,2105,4589,
6410,YFL033C,6572,5874,12446,4264,4499,4829,
6411,YLL066W-A,6104,6344,12448,6431,6573,6594,
6412,YPL189W,6305,6145,12450,3925,4179,5769,
6413,YCR079W,6052,6398,12450,6518,6475,5862,
6414,YML119W,5982,6474,12456,6047,5720,5788,
6415,YMR282C,6477,5979,12456,4783,4498,5865,
6416,YOR231W,6630,5827,12457,5608,4510,5956,
6417,YDL068W,6559,5899,12458,5780,5909,6577,
6418,YDR278C,6169,6293,12462,5335,5463,6482,
6419,YPL283W-B,6294,6172,12466,6347,6551,6563,
6420,YHR219C-A,6136,6333,12469,6376,6550,6573,
6421,YFR057W,6377,6093,12470,5093,4068,6417,
6422,YJL086C,6206,6267,12473,4266,4211,5339,
6423,YKL111C,6012,6462,12474,5092,5511,6518,
6424,YBR292C,6666,5808,12474,4090,4149,5488,
6425,YGL260W,6292,6188,12480,6149,5655,6556,
6426,YBR182C-A,6022,6464,12486,4072,4708,5421,
6427,YPL155C,6656,5835,12491,5618,5706,4666,
6428,YER129W,6120,6377,12497,5077,4581,5883,
6429,YGR238C,6638,5861,12499,5137,4703,5276,
6430,YHR049C-A,6135,6366,12501,6482,6296,6342,
6431,YCR089W,6445,6058,12503,4136,2409,4792,
6432,YLR467C-A,6077,6428,12505,6402,6576,6586,
6433,YNL126W,6190,6315,12505,4119,3176,5267,
6434,YER005W,6233,6273,12506,4686,4855,5254,
6435,YDR169C,6573,5936,12509,5646,4542,5172,
6436,YKR101W,5926,6585,12511,5556,4470,5227,
6437,YGR051C,6456,6056,12512,6548,6350,6352,
6438,YPR002C-A,6528,5985,12513,3270,4512,5318,
6439,YDL180W,6574,5940,12514,4575,4813,5656,
6440,YMR030W-A,5914,6601,12515,5167,4157,5998,
6441,YGR151C,6669,5851,12520,6314,6262,6595,
6442,YAL067W-A,5920,6607,12527,6593,6513,6623,
6443,YBL113W-A,6186,6342,12528,6334,6533,6559,
6444,YNL339W-B,6142,6386,12528,6377,6548,6570,
6445,YDR250C,6285,6243,12528,6118,5888,5914,
6446,YER006C-A,6473,6064,12537,2459,2740,5920,
6447,YDR183C-A,5985,6553,12538,1392,330,5078,
6448,YDR157W,6491,6047,12538,2327,1657,5902,
6449,YDR124W,6214,6330,12544,5998,5148,5887,
6450,YFR009W-A,6202,6343,12545,3689,2089,5687,
6451,YLR466C-A,6121,6432,12553,6403,6575,6587,
6452,YOR396C-A,6163,6391,12554,6400,6574,6588,
6453,YNL076W,6259,6296,12555,4931,4696,5566,
6454,YNL226W,6102,6453,12555,5817,4700,6603,
6455,YLL051C,6037,6518,12555,5377,5580,6201,
6456,YDR199W,6639,5917,12556,5188,2011,6392,
6457,YOR161W-B,5961,6597,12558,6529,6140,6047,
6458,YMR070W,5981,6580,12561,3916,4735,5011,
6459,YPR087W,5934,6630,12564,6524,5346,6411,
6460,YJL202C,6461,6109,12570,5012,5474,6012,
6461,YML133W-B,6197,6373,12570,6378,6549,6572,
6462,YCR038W-A,6301,6271,12572,6554,5823,6435,
6463,YIL068W-A,6598,5976,12574,5917,6279,6453,
6464,YDR491C,6533,6043,12576,6300,5786,6527,
6465,YCR101C,6330,6246,12576,4124,3819,5409,
6466,YDR369C,6358,6224,12582,3012,2230,3719,
6467,YGL204C,6347,6240,12587,4775,1338,6213,
6468,YOR102W,6090,6498,12588,5923,5013,6056,
6469,YBL073W,6590,6000,12590,5028,5804,6343,
6470,YJR127C,6396,6194,12590,4978,4579,4988,
6471,YOL013W-A,6339,6253,12592,6078,6078,3378,
6472,YGR141W,6552,6041,12593,4424,4180,4879,
6473,YKL053W,6087,6506,12593,6434,6601,6514,
6474,YNL205C,6519,6074,12593,6146,5916,6394,
6475,YMR193C-A,6250,6346,12596,940,1051,5658,
6476,YBR228W,6479,6134,12613,5139,4544,5685,
6477,YPR015C,6225,6390,12615,6105,5594,6036,
6478,YNL078W,6099,6517,12616,6312,6274,6028,
6479,YLR184W,6151,6477,12628,6428,6286,6200,
6480,YOR183W,6088,6540,12628,6152,6042,6426,
6481,YHR095W,6591,6040,12631,5489,5404,6368,
6482,YLR154W-A,6007,6625,12632,6535,6427,6414,
6483,YLR123C,6488,6149,12637,5876,6186,6280,
6484,YLL067W-A,6159,6484,12643,6432,6571,6592,
6485,YJL144W,6517,6127,12644,6563,6545,6274,
6486,YBR298C-A,6097,6548,12645,6410,6191,5804,
6487,YDR544C,6203,6444,12647,2208,6365,5761,
6488,YGR166W,6480,6167,12647,4586,3552,5149,
6489,YDL016C,6016,6633,12649,6232,4775,6245,
6490,YKR029C,6187,6466,12653,4178,1587,4326,
6491,YOL079W,6523,6130,12653,6292,5796,6367,
6492,YLR273C,6455,6202,12657,2792,2036,3566,
6493,YAL010C,6658,6003,12661,3903,3139,5511,
6494,YPR108W-A,6328,6335,12663,6295,6116,6437,
6495,YCR038C,6654,6010,12664,3869,5494,5129,
6496,YDR360W,6141,6524,12665,6579,6559,6608,
6497,YJR036C,6366,6303,12669,5516,4575,5608,
6498,YML083C,6258,6412,12670,5866,5881,4959,
6499,YAR064W,6483,6190,12673,6460,6556,6315,
6500,YMR105W-A,6164,6512,12676,5873,5238,6319,
6501,YBR103C-A,6241,6442,12683,6034,6083,6683,
6502,YER175W-A,6055,6639,12694,5196,5437,6330,
6503,YNL184C,6273,6427,12700,6158,6442,6440,
6504,YGL071W,6544,6170,12714,3764,3597,4011,
6505,YGR226C,6127,6595,12722,4201,5894,6236,
6506,YBR128C,6317,6413,12730,5380,5364,5832,
6507,YLR279W,6383,6349,12732,6670,6674,6679,
6508,YFL068W,6257,6491,12748,6433,6572,6593,
6509,YGR098C,6388,6362,12750,4269,3673,5448,
6510,YHR214C-E,6283,6469,12752,5262,6028,6328,
6511,YOR235W,6224,6532,12756,5000,5216,6268,
6512,YNR045W,6620,6138,12758,5895,6098,5999,
6513,YCL027W,6315,6446,12761,5794,5250,5542,
6514,Q0142,6119,6650,12769,2511,952,6540,
6515,YEL074W,6474,6297,12771,5303,5998,5681,
6516,YDR420W,6625,6152,12777,5981,4842,5747,
6517,YPR117W,6428,6357,12785,4098,3144,4729,
6518,YLR157W-E,6398,6403,12801,6242,6465,4834,
6519,YBR201C-A,6641,6160,12801,5785,5449,6532,
6520,YLR154C-G,6130,6672,12802,6647,6679,6549,
6521,YOR205C,6216,6589,12805,5500,4747,5307,
6522,YDR205W,6563,6250,12813,4955,3848,4808,
6523,YJR058C,6439,6378,12817,6261,6091,5950,
6524,YHR073W-A,6635,6183,12818,6578,6467,6429,
6525,YDR194W-A,6215,6603,12818,5882,4109,6101,
6526,YCR095W-A,6192,6628,12820,5984,4258,5880,
6527,YEL050W-A,6319,6501,12820,5592,5853,6467,
6528,YDR350C,6467,6355,12822,5305,4284,5802,
6529,YOR044W,6594,6236,12830,5934,5335,5683,
6530,YOR017W,6446,6388,12834,4068,4082,4950,
6531,Q0297,6399,6436,12835,6678,6661,6607,
6532,YBR196C-A,6432,6404,12836,1978,4505,5828,
6533,YDL142C,6318,6519,12837,6102,5530,6092,
6534,YIL092W,6460,6380,12840,5459,4904,5419,
6535,YLR156C-A,6229,6616,12845,6630,6328,6360,
6536,YDR095C,6647,6205,12852,6587,6624,6582,
6537,YLR101C,6659,6193,12852,4496,5546,6137,
6538,YBL109W,6374,6480,12854,1936,6203,6204,
6539,YHL028W,6410,6450,12860,6248,5863,6197,
6540,YGR228W,6322,6544,12866,3040,472,5537,
6541,YOL148C,6607,6264,12871,5087,3102,5090,
6542,YEL045C,6384,6489,12873,5709,6377,6547,
6543,YIL117C,6450,6426,12876,5288,3642,5550,
6544,YEL010W,6338,6543,12881,6337,5838,6492,
6545,Q0143,6268,6614,12882,2301,626,5052,
6546,YHR125W,6429,6454,12883,4764,5470,6066,
6547,YBR191W-A,6207,6681,12888,4220,204,6640,
6548,YLR157C-C,6271,6620,12891,6629,6326,6361,
6549,YGR041W,6521,6372,12893,4577,4111,5744,
6550,YER145C-A,6389,6510,12899,6544,6408,6111,
6551,YDR431W,6447,6452,12899,5354,5279,6508,
6552,YOR161C-C,6240,6664,12904,6565,6443,6575,
6553,YPL168W,6662,6242,12904,4879,4550,5289,
6554,YIL071W-A,6438,6468,12906,6114,5277,6513,
6555,YLL019W-A,6270,6636,12906,6164,5767,6142,
6556,YPL209C,6413,6497,12910,5384,4200,4541,
6557,YIL105W-A,6246,6673,12919,545,14,4524,
6558,YLR162W,6434,6485,12919,6582,6663,5938,
6559,YLR317W,6453,6471,12924,5956,5375,6548,
6560,YKL100W-A,6386,6545,12931,4677,5987,4030,
6561,YHR217C,6604,6327,12931,2370,6163,5778,
6562,YER084W-A,6403,6533,12936,4303,5656,6306,
6563,YHR131C,6499,6443,12942,4954,5145,4496,
6564,YPL230W,6524,6445,12969,5309,5204,5501,
6565,YER078W-A,6327,6653,12980,6435,6583,6584,
6566,YLR342W-A,6444,6536,12980,3113,2356,6095,
6567,YCL051W,6457,6523,12980,5053,4373,4923,
6568,YPR170W-A,6496,6486,12982,3599,4959,6350,
6569,YBR141W-A,6392,6594,12986,6649,6494,6339,
6570,YPR074W-A,6458,6530,12988,6618,6641,6488,
6571,YJL197C-A,6579,6411,12990,4683,847,6262,
6572,YHR086W-A,6435,6558,12993,6333,6584,6664,
6573,YIL054W,6372,6622,12994,4941,5835,5935,
6574,YML099W-A,6535,6459,12994,6045,5951,6400,
6575,YKL123W,6489,6513,13002,6091,5033,6080,
6576,YLR222C-A,6441,6562,13003,971,83,4750,
6577,YLR332W,6503,6503,13006,4659,4328,5798,
6578,YLR154C-H,6375,6632,13007,6631,6327,6363,
6579,YLR159C-A,6380,6629,13009,6632,6329,6362,
6580,YDL022C-A,6437,6578,13015,5613,5369,6064,
6581,YMR086C-A,6597,6425,13022,6311,5083,6676,
6582,YAR068W,6578,6449,13027,6668,6275,6644,
6583,YLR198C,6415,6612,13027,1613,459,6585,
6584,YBL039C-A,6500,6529,13029,5458,5647,5495,
6585,YGR176W,6538,6493,13031,6665,6650,6674,
6586,YER158W-A,6602,6429,13031,6595,6633,6643,
6587,YMR019W,6636,6397,13033,2900,3100,5179,
6588,YOL164W-A,6529,6505,13034,1312,3509,5636,
6589,YIR018C-A,6494,6541,13035,4073,4595,5982,
6590,YJL142C,6653,6395,13048,6486,5768,6468,
6591,YDR034C-A,6400,6649,13049,1040,231,4209,
6592,YNR025C,6484,6565,13049,6036,4933,6396,
6593,YGL041C-B,6624,6435,13059,5748,5702,6677,
6594,YOR053W,6394,6666,13060,6001,6671,6649,
6595,YHR214W-A,6581,6479,13060,6667,6243,6639,
6596,YBL071C-B,6452,6613,13065,3472,3270,6115,
6597,YPL222C-A,6421,6645,13066,6617,6414,6647,
6598,YGR240C-A,6442,6626,13068,5559,4547,6189,
6599,YLR154W-B,6536,6534,13070,6654,6680,6662,
6600,YDR406W-A,6548,6525,13073,1170,560,3645,
6601,YOR105W,6501,6572,13073,6338,6214,6067,
6602,YJL028W,6423,6652,13075,6602,6643,6665,
6603,YNL176C,6600,6478,13078,6022,5182,6193,
6604,YBL053W,6402,6676,13078,5737,3038,6341,
6605,YLR466C-B,6599,6482,13081,5242,6457,6329,
6606,YJL047C-A,6637,6447,13084,6325,6370,6475,
6607,YGR146C-A,6411,6674,13085,6086,4387,6390,
6608,YNL277W-A,6418,6668,13086,6571,6153,6633,
6609,YGL146C,6570,6516,13086,6342,6212,6344,
6610,YOR394C-A,6678,6414,13092,5624,6095,6609,
6611,YMR254C,6498,6600,13098,6257,5324,6399,
6612,YBL008W-A,6553,6547,13100,4449,5372,6531,
6613,YGR035W-A,6583,6520,13103,5604,5887,6024,
6614,YER084W,6516,6588,13104,6308,6381,6486,
6615,Q0017,6596,6509,13105,5030,5743,6571,
6616,YBR224W,6537,6570,13107,6265,6107,6238,
6617,YOR029W,6495,6615,13110,6484,6388,6610,
6618,YMR055C,6648,6463,13111,6330,6351,6209,
6619,YOR314W-A,6546,6566,13112,3967,3657,6455,
6620,YKL106C-A,6459,6654,13113,6589,6651,6629,
6621,YER138W-A,6564,6550,13114,3015,884,6148,
6622,YPL152W-A,6492,6627,13119,4046,5687,6617,
6623,YLR169W,6589,6531,13120,6115,6261,6648,
6624,YOL150C,6475,6647,13122,6167,3156,6175,
6625,YHR212W-A,6569,6555,13124,6395,4980,6011,
6626,YDR024W,6566,6560,13126,6371,6310,6551,
6627,YNL179C,6522,6608,13130,5664,5528,6606,
6628,YAL069W,6584,6546,13130,6238,6233,6490,
6629,YMR040W,6611,6522,13133,5485,5690,6034,
6630,YGR023W,6586,6551,13137,5635,5137,5526,
6631,YDR126W,6651,6487,13138,5317,5684,6018,
6632,YHL048C-A,6551,6593,13144,6049,5736,5698,
6633,YNL269W,6486,6662,13148,6332,6280,5722,
6634,YJR115W,6652,6502,13154,5717,6369,6381,
6635,YGR137W,6576,6581,13157,6533,6604,6569,
6636,YER181C,6642,6521,13163,6294,5890,6615,
6637,YJR120W,6541,6623,13164,6603,6619,6499,
6638,YKL083W,6580,6609,13189,4438,4566,6558,
6639,YCR097W-A,6655,6538,13193,5074,4516,6590,
6640,YBR223W-A,6667,6526,13193,6684,6681,6680,
6641,YKL225W,6631,6563,13194,3749,5175,6430,
6642,YGL168W,6575,6621,13196,6083,4907,6303,
6643,YBR131C-A,6512,6684,13196,6344,4924,6645,
6644,YIL046W-A,6661,6537,13198,5044,3301,6530,
6645,YMR013W-A,6614,6590,13204,5712,6105,6583,
6646,YLR230W,6627,6577,13204,6372,6195,6616,
6647,YBR076C-A,6609,6606,13215,6124,6464,5813,
6648,YCR024C-B,6619,6598,13217,2533,3999,6191,
6649,YGR069W,6628,6605,13233,3808,1814,6523,
6650,YEL032C-A,6671,6564,13235,6350,6458,6654,
6651,YNR075C-A,6595,6644,13239,6679,6662,6673,
6652,YFL021W,6610,6631,13241,5429,6316,5234,
6653,YHR063W-A,6585,6660,13245,6411,5386,6301,
6654,YFL063W,6605,6642,13247,4222,5558,6218,
6655,YML116W-A,6645,6610,13255,6637,6597,6678,
6656,Q0092,6684,6573,13257,4983,5383,6624,
6657,YNL130C-A,6668,6592,13260,5675,5699,6666,
6658,YBR027C,6650,6611,13261,5020,5102,6325,
6659,YMR230W-A,6676,6587,13263,1712,1126,6404,
6660,YFL010W-A,6649,6617,13266,4786,6500,6670,
6661,YCL042W,6622,6648,13270,6648,6579,6382,
6662,YLR202C,6633,6640,13273,5300,5326,6371,
6663,YLR120W-A,6621,6656,13277,6266,6160,6598,
6664,YIL100C-A,6632,6646,13278,6492,6585,6671,
6665,YOR231C-A,6640,6638,13278,4679,5915,6661,
6666,YML047W-A,6623,6659,13282,5520,5140,6620,
6667,YGL007C-A,6615,6670,13285,5548,5055,6043,
6668,YJL077C,6643,6651,13294,6472,6229,6521,
6669,YJR151W-A,6616,6679,13295,6220,6374,6269,
6670,YDL247W-A,6617,6678,13295,6227,3849,6632,
6671,YJL150W,6660,6635,13295,5661,5718,6535,
6672,YKR047W,6629,6671,13300,6545,6625,6675,
6673,YLR285C-A,6681,6619,13300,4654,1339,6652,
6674,YJL136W-A,6663,6643,13306,6299,5923,6682,
6675,YHR175W-A,6683,6641,13324,5363,5568,6421,
6676,YAR035C-A,6644,6680,13324,6657,6682,6663,
6677,YOL155W-A,6670,6658,13328,6176,6032,6300,
6678,YOR293C-A,6673,6665,13338,6163,5679,6462,
6679,YKL037W,6672,6667,13339,6627,6613,6489,
6680,YGR204C-A,6682,6663,13345,3047,5499,5498,
6681,YLR406C-A,6680,6669,13349,6419,5959,6304,
6682,YLR299C-A,6675,6675,13350,2521,6118,6014,
6683,YHR073C-B,6679,6677,13356,4603,2665,5527,
6684,YMR182W-A,6677,6682,13359,6585,5878,6656,
